Ranking de Población;Nombre;Provincia;Comunidad Autónoma;Población;Número de Hombres;Número de Mujeres
7192;Ababuj;Teruel;Aragón;73;45;28
3360;Abades;Segovia;Castilla y León;848;417;431
4800;Abadía;Cáceres;Extremadura;331;184;147
2044;Abadín;Lugo;Galicia;2367;1157;1210
942;Abadiño;Bizkaia;País Vasco;7599;3815;3784
7034;Abáigar;Navarra;Navarra;83;48;35
7880;Abajas;Burgos;Castilla y León;31;21;10
5234;Ábalos;Rioja, La;La Rioja;257;149;108
4791;Abaltzisketa;Gipuzkoa;País Vasco;333;181;152
7614;Abánades;Guadalajara;Castilla-La Mancha;48;26;22
1112;Abanilla;Murcia;Región de Murcia;6127;3112;3015
6797;Abanto;Zaragoza;Aragón;100;59;41
789;Abanto y Ciérvana-Abanto Zierbena;Bizkaia;País Vasco;9444;4668;4776
605;Abarán;Murcia;Región de Murcia;12964;6479;6485
7673;Abarca de Campos;Palencia;Castilla y León;44;27;17
4022;Abárzuza/Abartzuza;Navarra;Navarra;538;265;273
6397;Abaurregaina/Abaurrea Alta;Navarra;Navarra;126;77;49
7869;Abaurrepea/Abaurrea Baja;Navarra;Navarra;32;19;13
1220;Abegondo;Coruña, A;Galicia;5406;2655;2751
4988;Abejar;Soria;Castilla y León;297;155;142
7621;Abejuela;Teruel;Aragón;48;31;17
5836;Abella de la Conca;Lleida;Cataluña;179;96;83
3452;Abengibre;Albacete;Castilla-La Mancha;790;379;411
2685;Abenójar;Ciudad Real;Castilla-La Mancha;1375;711;664
4668;Aberin;Navarra;Navarra;359;193;166
4470;Abertura;Cáceres;Extremadura;407;205;202
7373;Abezames;Zamora;Castilla y León;61;30;31
7298;Abia de la Obispalía;Cuenca;Castilla-La Mancha;65;40;25
5961;Abia de las Torres;Palencia;Castilla y León;165;89;76
5306;Abiego;Huesca;Aragón;248;130;118
6152;Abizanda;Huesca;Aragón;150;76;74
2816;Abla;Almería;Andalucía;1249;635;614
7391;Ablanque;Guadalajara;Castilla-La Mancha;59;31;28
1994;Ablitas;Navarra;Navarra;2481;1252;1229
621;Abrera;Barcelona;Cataluña;12489;6326;6163
2864;Abrucena;Almería;Andalucía;1202;637;565
5796;Abusejo;Salamanca;Castilla y León;183;98;85
7019;Acebeda, La;Madrid;Comunidad de Madrid;84;44;40
5742;Acebedo;León;Castilla y León;187;107;80
3930;Acebo;Cáceres;Extremadura;579;292;287
5390;Acebrón, El;Cuenca;Castilla-La Mancha;234;115;119
3432;Acedera;Badajoz;Extremadura;807;416;391
3437;Acehúche;Cáceres;Extremadura;801;405;396
3851;Aceituna;Cáceres;Extremadura;607;312;295
5957;Acered;Zaragoza;Aragón;166;98;68
1212;Aceuchal;Badajoz;Extremadura;5449;2711;2738
5851;Adahuesca;Huesca;Aragón;177;96;81
7530;Adalia;Valladolid;Castilla y León;53;33;20
1447;Adamuz;Córdoba;Andalucía;4192;2157;2035
5670;Adanero;Ávila;Castilla y León;196;111;85
150;Adeje;Santa Cruz de Tenerife;Canarias;47869;24110;23759
3070;Ademuz;Valencia/València;Comunidad Valenciana;1042;568;474
6087;Adiós;Navarra;Navarra;155;87;68
7920;Adobes;Guadalajara;Castilla-La Mancha;29;16;13
2578;Ador;Valencia/València;Comunidad Valenciana;1508;804;704
315;Adra;Almería;Andalucía;25148;12833;12315
5618;Adrada de Haza;Burgos;Castilla y León;203;101;102
7756;Adrada de Pirón;Segovia;Castilla y León;39;21;18
1995;Adrada, La;Ávila;Castilla y León;2480;1286;1194
7242;Adradas;Soria;Castilla y León;69;36;33
6405;Adrados;Segovia;Castilla y León;126;73;53
4240;Aduna;Gipuzkoa;País Vasco;469;253;216
1188;Agaete;Palmas, Las;Canarias;5586;2792;2794
6305;Agallas;Salamanca;Castilla y León;136;70;66
3904;Àger;Lleida;Cataluña;588;320;268
2055;Agolada;Pontevedra;Galicia;2344;1175;1169
6298;Agón;Zaragoza;Aragón;137;80;57
2997;Agoncillo;Rioja, La;La Rioja;1102;606;496
1339;Agost;Alicante/Alacant;Comunidad Valenciana;4758;2357;2401
1229;Agramunt;Lleida;Cataluña;5371;2689;2682
1776;Ágreda;Soria;Castilla y León;3001;1535;1466
3960;Agres;Alicante/Alacant;Comunidad Valenciana;565;306;259
5122;Agrón;Granada;Andalucía;274;134;140
2243;Aguadulce;Sevilla;Andalucía;2020;1003;1017
3777;Aguarón;Zaragoza;Aragón;636;337;299
7456;Aguas Cándidas;Burgos;Castilla y León;56;35;21
8062;Aguasal;Valladolid;Castilla y León;19;12;7
8071;Aguatón;Teruel;Aragón;18;6;12
4099;Aguaviva;Teruel;Aragón;514;247;267
2472;Agudo;Ciudad Real;Castilla-La Mancha;1659;830;829
6369;Agüero;Huesca;Aragón;129;76;53
3943;Aguilafuente;Segovia;Castilla y León;573;286;287
7405;Aguilar de Bureba;Burgos;Castilla y León;58;38;20
1035;Aguilar de Campoo;Palencia;Castilla y León;6744;3262;3482
5335;Aguilar de Campos;Valladolid;Castilla y León;243;140;103
7265;Aguilar de Codés;Navarra;Navarra;67;39;28
595;Aguilar de la Frontera;Córdoba;Andalucía;13328;6678;6650
5035;Aguilar de Segarra;Barcelona;Cataluña;288;155;133
7333;Aguilar del Alfambra;Teruel;Aragón;63;36;27
4270;Aguilar del Río Alhama;Rioja, La;La Rioja;460;234;226
208;Águilas;Murcia;Región de Murcia;35301;17620;17681
5288;Aguilón;Zaragoza;Aragón;251;136;115
237;Agüimes;Palmas, Las;Canarias;31619;15984;15635
3387;Agullana;Girona;Cataluña;831;411;420
2027;Agullent;Valencia/València;Comunidad Valenciana;2410;1191;1219
3002;Agulo;Santa Cruz de Tenerife;Canarias;1096;547;549
1288;Agurain/Salvatierra;Araba/Álava;País Vasco;5062;2526;2536
2691;Ahigal;Cáceres;Extremadura;1372;706;666
6551;Ahigal de los Aceiteros;Salamanca;Castilla y León;114;64;50
7887;Ahigal de Villarino;Salamanca;Castilla y León;31;17;14
3326;Ahillones;Badajoz;Extremadura;871;430;441
2212;Aia;Gipuzkoa;País Vasco;2054;1092;962
3434;Aibar/Oibar;Navarra;Navarra;805;425;380
1366;Aielo de Malferit;Valencia/València;Comunidad Valenciana;4618;2324;2294
6095;Aielo de Rugat;Valencia/València;Comunidad Valenciana;155;85;70
1979;Aiguafreda;Barcelona;Cataluña;2504;1208;1296
3288;Aiguamúrcia;Tarragona;Cataluña;901;465;436
3519;Aiguaviva;Girona;Cataluña;756;383;373
3193;Aigües;Alicante/Alacant;Comunidad Valenciana;963;505;458
6387;Aín;Castellón/Castelló;Comunidad Valenciana;127;64;63
2136;Aínsa-Sobrarbe;Huesca;Aragón;2201;1120;1081
3027;Ainzón;Zaragoza;Aragón;1077;542;535
4855;Aisa;Huesca;Aragón;320;176;144
1942;Aitona;Lleida;Cataluña;2591;1358;1233
3483;Aizarnazabal;Gipuzkoa;País Vasco;772;391;381
1347;Ajalvir;Madrid;Comunidad de Madrid;4712;2438;2274
7286;Ajamil de Cameros;Rioja, La;La Rioja;66;45;21
4220;Ajangiz;Bizkaia;País Vasco;477;249;228
2103;Ajofrín;Toledo;Castilla-La Mancha;2264;1135;1129
5280;Alacón;Teruel;Aragón;252;129;123
7550;Aladrén;Zaragoza;Aragón;52;34;18
2696;Alaejos;Valladolid;Castilla y León;1369;732;637
995;Alagón;Zaragoza;Aragón;7163;3572;3591
3251;Alagón del Río;Cáceres;Extremadura;932;464;468
824;Alaior;Balears, Illes;Islas Baleares;9065;4576;4489
3520;Alájar;Huelva;Andalucía;756;386;370
2245;Alajeró;Santa Cruz de Tenerife;Canarias;2017;1061;956
1228;Alameda;Málaga;Andalucía;5372;2735;2637
7227;Alameda de Gardón, La;Salamanca;Castilla y León;70;36;34
1587;Alameda de la Sagra;Toledo;Castilla-La Mancha;3623;1912;1711
5645;Alameda del Valle;Madrid;Comunidad de Madrid;200;119;81
3939;Alamedilla;Granada;Andalucía;574;288;286
6401;Alamedilla, La;Salamanca;Castilla y León;126;63;63
4183;Alamillo;Ciudad Real;Castilla-La Mancha;486;249;237
7379;Alaminos;Guadalajara;Castilla-La Mancha;60;28;32
788;Álamo, El;Madrid;Comunidad de Madrid;9470;4696;4774
3407;Alamús, Els;Lleida;Cataluña;819;412;407
2331;Alange;Badajoz;Extremadura;1848;935;913
2431;Alanís;Sevilla;Andalucía;1723;867;856
259;Alaquàs;Valencia/València;Comunidad Valenciana;29561;14527;15034
3246;Alar del Rey;Palencia;Castilla y León;934;454;480
4352;Alaraz;Salamanca;Castilla y León;439;230;209
6425;Alarba;Zaragoza;Aragón;124;71;53
6171;Alarcón;Cuenca;Castilla-La Mancha;148;67;81
5977;Alarilla;Guadalajara;Castilla-La Mancha;163;104;59
1189;Alaró;Balears, Illes;Islas Baleares;5572;2689;2883
4812;Alàs i Cerc;Lleida;Cataluña;329;171;158
4085;Alatoz;Albacete;Castilla-La Mancha;519;291;228
5915;Alba;Teruel;Aragón;170;94;76
6977;Alba de Cerrato;Palencia;Castilla y León;87;47;40
1264;Alba de Tormes;Salamanca;Castilla y León;5186;2603;2583
5597;Alba de Yeltes;Salamanca;Castilla y León;207;111;96
37;Albacete;Albacete;Castilla-La Mancha;173329;84687;88642
4625;Albagés, L';Lleida;Cataluña;369;194;175
1139;Albaida;Valencia/València;Comunidad Valenciana;5900;2921;2979
1711;Albaida del Aljarafe;Sevilla;Andalucía;3197;1601;1596
501;Albal;Valencia/València;Comunidad Valenciana;16399;8213;8186
3655;Albalá;Cáceres;Extremadura;689;364;325
2926;Albaladejo;Ciudad Real;Castilla-La Mancha;1158;601;557
5324;Albaladejo del Cuende;Cuenca;Castilla-La Mancha;245;127;118
1660;Albalat de la Ribera;Valencia/València;Comunidad Valenciana;3360;1689;1671
1494;Albalat dels Sorells;Valencia/València;Comunidad Valenciana;3977;1950;2027
2838;Albalat dels Tarongers;Valencia/València;Comunidad Valenciana;1232;644;588
2996;Albalate de Cinca;Huesca;Aragón;1103;592;511
5261;Albalate de las Nogueras;Cuenca;Castilla-La Mancha;253;132;121
3229;Albalate de Zorita;Guadalajara;Castilla-La Mancha;943;520;423
2270;Albalate del Arzobispo;Teruel;Aragón;1980;1013;967
5857;Albalatillo;Huesca;Aragón;176;93;83
3548;Albanchez;Almería;Andalucía;741;379;362
3094;Albanchez de Mágina;Jaén;Andalucía;1024;532;492
6054;Albanyà;Girona;Cataluña;157;80;77
4102;Albares;Guadalajara;Castilla-La Mancha;513;264;249
3093;Albarracín;Teruel;Aragón;1025;521;504
3672;Albarreal de Tajo;Toledo;Castilla-La Mancha;683;353;330
3649;Albatana;Albacete;Castilla-La Mancha;692;356;336
2128;Albatàrrec;Lleida;Cataluña;2221;1150;1071
633;Albatera;Alicante/Alacant;Comunidad Valenciana;12279;6260;6019
3637;Albelda;Huesca;Aragón;698;364;334
1634;Albelda de Iregua;Rioja, La;La Rioja;3446;1763;1683
6453;Albendea;Cuenca;Castilla-La Mancha;121;57;64
7598;Albendiego;Guadalajara;Castilla-La Mancha;49;30;19
5115;Albentosa;Teruel;Aragón;276;149;127
2517;Alberca de Záncara, La;Cuenca;Castilla-La Mancha;1590;807;783
3020;Alberca, La;Salamanca;Castilla y León;1081;527;554
6586;Alberguería de Argañán, La;Salamanca;Castilla y León;112;57;55
721;Alberic;Valencia/València;Comunidad Valenciana;10526;5190;5336
2016;Alberite;Rioja, La;La Rioja;2422;1225;1197
7245;Alberite de San Juan;Zaragoza;Aragón;69;40;29
6509;Albero Alto;Huesca;Aragón;117;67;50
6313;Albero Bajo;Huesca;Aragón;135;72;63
4965;Alberuela de Tubo;Huesca;Aragón;301;151;150
2545;Albesa;Lleida;Cataluña;1556;855;701
6338;Albeta;Zaragoza;Aragón;133;70;63
3499;Albi, L';Lleida;Cataluña;764;389;375
5582;Albillos;Burgos;Castilla y León;209;109;100
2004;Albinyana;Tarragona;Cataluña;2438;1243;1195
4184;Albiol, L';Tarragona;Cataluña;485;253;232
4949;Albiztur;Gipuzkoa;País Vasco;304;159;145
2824;Albocàsser;Castellón/Castelló;Comunidad Valenciana;1241;630;611
3832;Alboloduy;Almería;Andalucía;616;302;314
438;Albolote;Granada;Andalucía;18808;9304;9504
3577;Albondón;Granada;Andalucía;728;408;320
3480;Albons;Girona;Cataluña;776;401;375
2921;Alborache;Valencia/València;Comunidad Valenciana;1160;608;552
322;Alboraia/Alboraya;Valencia/València;Comunidad Valenciana;24454;11976;12478
3729;Alborea;Albacete;Castilla-La Mancha;658;337;321
6672;Alborge;Zaragoza;Aragón;107;56;51
5788;Albornos;Ávila;Castilla y León;183;98;85
656;Albox;Almería;Andalucía;11805;6031;5774
2688;Albudeite;Murcia;Región de Murcia;1373;694;679
2232;Albuera, La;Badajoz;Extremadura;2028;1064;964
1490;Albuixech;Valencia/València;Comunidad Valenciana;4017;1975;2042
4477;Albuñán;Granada;Andalucía;406;208;198
991;Albuñol;Granada;Andalucía;7233;3952;3281
3403;Albuñuelas;Granada;Andalucía;821;408;413
1233;Alburquerque;Badajoz;Extremadura;5343;2659;2684
3664;Alcabón;Toledo;Castilla-La Mancha;686;351;335
3736;Alcadozo;Albacete;Castilla-La Mancha;654;363;291
7401;Alcaine;Teruel;Aragón;59;36;23
5322;Alcalá de Ebro;Zaragoza;Aragón;246;118;128
100;Alcalá de Guadaíra;Sevilla;Andalucía;75279;37379;37900
5307;Alcalá de Gurrea;Huesca;Aragón;248;131;117
31;Alcalá de Henares;Madrid;Comunidad de Madrid;195649;95234;100415
4742;Alcalá de la Selva;Teruel;Aragón;343;188;155
6886;Alcalá de la Vega;Cuenca;Castilla-La Mancha;93;55;38
1259;Alcalá de los Gazules;Cádiz;Andalucía;5219;2684;2535
6236;Alcalá de Moncayo;Zaragoza;Aragón;143;84;59
1044;Alcalà de Xivert;Castellón/Castelló;Comunidad Valenciana;6680;3412;3268
2905;Alcalá del Júcar;Albacete;Castilla-La Mancha;1170;618;552
4870;Alcalá del Obispo;Huesca;Aragón;318;173;145
647;Alcalá del Río;Sevilla;Andalucía;12029;6116;5913
1293;Alcalá del Valle;Cádiz;Andalucía;5046;2538;2508
371;Alcalá la Real;Jaén;Andalucía;21605;10612;10993
2776;Alcalalí;Alicante/Alacant;Comunidad Valenciana;1278;640;638
3796;Alcampell;Huesca;Aragón;631;310;321
3761;Alcanadre;Rioja, La;La Rioja;643;338;305
792;Alcanar;Tarragona;Cataluña;9418;4748;4670
5383;Alcanó;Lleida;Cataluña;235;119;116
2620;Alcántara;Cáceres;Extremadura;1468;736;732
167;Alcantarilla;Murcia;Región de Murcia;42048;20794;21254
2765;Alcàntera de Xúquer;Valencia/València;Comunidad Valenciana;1291;646;645
7558;Alcantud;Cuenca;Castilla-La Mancha;51;28;23
3029;Alcañices;Zamora;Castilla y León;1076;560;516
513;Alcañiz;Teruel;Aragón;15947;7911;8036
5125;Alcañizo;Toledo;Castilla-La Mancha;274;139;135
2602;Alcaracejos;Córdoba;Andalucía;1486;723;763
2713;Alcaraz;Albacete;Castilla-La Mancha;1351;703;648
785;Alcarràs;Lleida;Cataluña;9514;4957;4557
753;Alcàsser;Valencia/València;Comunidad Valenciana;10039;5043;4996
2121;Alcaucín;Málaga;Andalucía;2230;1140;1090
723;Alcaudete;Jaén;Andalucía;10498;5166;5332
2480;Alcaudete de la Jara;Toledo;Castilla-La Mancha;1648;833;815
249;Alcázar de San Juan;Ciudad Real;Castilla-La Mancha;30576;14908;15668
6121;Alcázar del Rey;Cuenca;Castilla-La Mancha;152;78;74
3781;Alcazarén;Valladolid;Castilla y León;635;343;292
509;Alcázares, Los;Murcia;Región de Murcia;16138;8238;7900
3920;Alcoba;Ciudad Real;Castilla-La Mancha;583;297;286
56;Alcobendas;Madrid;Comunidad de Madrid;117040;55954;61086
4902;Alcocer;Guadalajara;Castilla-La Mancha;313;157;156
5419;Alcocer de Planes;Alicante/Alacant;Comunidad Valenciana;230;117;113
7865;Alcocero de Mola;Burgos;Castilla y León;32;23;9
7935;Alcohujate;Cuenca;Castilla-La Mancha;28;15;13
3396;Alcolea;Almería;Andalucía;825;428;397
2663;Alcolea de Calatrava;Ciudad Real;Castilla-La Mancha;1409;714;695
2929;Alcolea de Cinca;Huesca;Aragón;1155;622;533
8106;Alcolea de las Peñas;Guadalajara;Castilla-La Mancha;13;8;5
3427;Alcolea de Tajo;Toledo;Castilla-La Mancha;810;399;411
4854;Alcolea del Pinar;Guadalajara;Castilla-La Mancha;320;172;148
1657;Alcolea del Río;Sevilla;Andalucía;3373;1683;1690
5887;Alcoleja;Alicante/Alacant;Comunidad Valenciana;173;93;80
1639;Alcoletge;Lleida;Cataluña;3420;1775;1645
5030;Alcollarín;Cáceres;Extremadura;289;146;143
5865;Alconaba;Soria;Castilla y León;176;114;62
6162;Alconada;Salamanca;Castilla y León;149;79;70
7981;Alconada de Maderuelo;Segovia;Castilla y León;25;16;9
2456;Alconchel;Badajoz;Extremadura;1680;846;834
7351;Alconchel de Ariza;Zaragoza;Aragón;62;37;25
6959;Alconchel de la Estrella;Cuenca;Castilla-La Mancha;88;51;37
3540;Alconera;Badajoz;Extremadura;744;366;378
4122;Alcóntar;Almería;Andalucía;505;278;227
728;Alcora, l';Castellón/Castelló;Comunidad Valenciana;10405;5255;5150
40;Alcorcón;Madrid;Comunidad de Madrid;170514;82139;88375
1691;Alcorisa;Teruel;Aragón;3266;1661;1605
6395;Alcoroches;Guadalajara;Castilla-La Mancha;126;79;47
1287;Alcover;Tarragona;Cataluña;5064;2499;2565
127;Alcoy/Alcoi;Alicante/Alacant;Comunidad Valenciana;58994;28866;30128
4661;Alcubierre;Huesca;Aragón;360;196;164
6724;Alcubilla de Avellaneda;Soria;Castilla y León;104;56;48
7447;Alcubilla de las Peñas;Soria;Castilla y León;57;35;22
6515;Alcubilla de Nogales;Zamora;Castilla y León;117;64;53
4221;Alcubillas;Ciudad Real;Castilla-La Mancha;477;239;238
3802;Alcublas;Valencia/València;Comunidad Valenciana;628;338;290
403;Alcúdia;Balears, Illes;Islas Baleares;20241;10252;9989
1270;Alcúdia de Crespins, l';Valencia/València;Comunidad Valenciana;5157;2561;2596
6118;Alcudia de Monteagud;Almería;Andalucía;152;73;79
5713;Alcudia de Veo;Castellón/Castelló;Comunidad Valenciana;190;103;87
649;Alcúdia, l';Valencia/València;Comunidad Valenciana;12009;5896;6113
1941;Alcuéscar;Cáceres;Extremadura;2593;1351;1242
233;Aldaia;Valencia/València;Comunidad Valenciana;31864;15858;16006
5467;Aldea de San Miguel;Valladolid;Castilla y León;224;123;101
954;Aldea de San Nicolás, La;Palmas, Las;Canarias;7504;3846;3658
3871;Aldea del Cano;Cáceres;Extremadura;600;286;314
1839;Aldea del Fresno;Madrid;Comunidad de Madrid;2838;1457;1381
5334;Aldea del Obispo;Salamanca;Castilla y León;243;126;117
4953;Aldea del Obispo, La;Cáceres;Extremadura;303;162;141
2475;Aldea del Rey;Ciudad Real;Castilla-La Mancha;1657;843;814
5982;Aldea en Cabo;Toledo;Castilla-La Mancha;163;86;77
5078;Aldea Real;Segovia;Castilla y León;282;149;133
1456;Aldea, L';Tarragona;Cataluña;4160;2197;1963
3934;Aldeacentenera;Cáceres;Extremadura;578;296;282
6643;Aldeacipreste;Salamanca;Castilla y León;109;57;52
2848;Aldeadávila de la Ribera;Salamanca;Castilla y León;1224;616;608
6906;Aldealafuente;Soria;Castilla y León;92;53;39
8023;Aldealcorvo;Segovia;Castilla y León;22;13;9
3714;Aldealengua;Salamanca;Castilla y León;664;328;336
7204;Aldealengua de Pedraza;Segovia;Castilla y León;72;45;27
7332;Aldealengua de Santa María;Segovia;Castilla y León;63;31;32
7805;Aldealices;Soria;Castilla y León;36;22;14
8079;Aldealpozo;Soria;Castilla y León;17;8;9
7890;Aldealseñor;Soria;Castilla y León;31;16;15
1198;Aldeamayor de San Martín;Valladolid;Castilla y León;5524;2859;2665
4084;Aldeanueva de Barbarroya;Toledo;Castilla-La Mancha;520;267;253
1871;Aldeanueva de Ebro;Rioja, La;La Rioja;2761;1438;1323
5255;Aldeanueva de Figueroa;Salamanca;Castilla y León;254;134;120
6988;Aldeanueva de Guadalajara;Guadalajara;Castilla-La Mancha;86;51;35
7677;Aldeanueva de la Serrezuela;Segovia;Castilla y León;44;32;12
6540;Aldeanueva de la Sierra;Salamanca;Castilla y León;115;66;49
2205;Aldeanueva de la Vera;Cáceres;Extremadura;2066;1015;1051
4406;Aldeanueva de San Bartolomé;Toledo;Castilla-La Mancha;427;213;214
6486;Aldeanueva de Santa Cruz;Ávila;Castilla y León;118;62;56
3564;Aldeanueva del Camino;Cáceres;Extremadura;735;361;374
6512;Aldeanueva del Codonal;Segovia;Castilla y León;117;64;53
4199;Aldeaquemada;Jaén;Andalucía;481;265;216
6233;Aldearrodrigo;Salamanca;Castilla y León;143;78;65
4207;Aldearrubia;Salamanca;Castilla y León;480;259;221
5367;Aldeaseca;Ávila;Castilla y León;238;116;122
7228;Aldeaseca de Alba;Salamanca;Castilla y León;70;34;36
5206;Aldeaseca de la Frontera;Salamanca;Castilla y León;261;137;124
7474;Aldeasoña;Segovia;Castilla y León;56;33;23
2206;Aldeatejada;Salamanca;Castilla y León;2064;1043;1021
6722;Aldeavieja de Tormes;Salamanca;Castilla y León;104;56;48
7527;Aldehorno;Segovia;Castilla y León;53;32;21
4644;Aldehuela de Jerte;Cáceres;Extremadura;364;192;172
5118;Aldehuela de la Bóveda;Salamanca;Castilla y León;275;147;128
7623;Aldehuela de Liestos;Zaragoza;Aragón;48;29;19
7724;Aldehuela de Periáñez;Soria;Castilla y León;41;23;18
5719;Aldehuela de Yeltes;Salamanca;Castilla y León;190;103;87
7971;Aldehuela del Codonal;Segovia;Castilla y León;26;14;12
5987;Aldehuela, La;Ávila;Castilla y León;162;83;79
7319;Aldehuelas, Las;Soria;Castilla y León;64;34;30
3835;Aldeire;Granada;Andalucía;615;322;293
7494;Aldeonte;Segovia;Castilla y León;55;30;25
3310;Aldover;Tarragona;Cataluña;882;445;437
3099;Aledo;Murcia;Región de Murcia;1022;505;517
2432;Alegia;Gipuzkoa;País Vasco;1722;890;832
1823;Alegría-Dulantzi;Araba/Álava;País Vasco;2876;1501;1375
3321;Aleixar, L';Tarragona;Cataluña;873;450;423
767;Alella;Barcelona;Cataluña;9801;4762;5039
7852;Alentisque;Soria;Castilla y León;33;20;13
5649;Alerre;Huesca;Aragón;199;101;98
4126;Alesanco;Rioja, La;La Rioja;505;267;238
6804;Alesón;Rioja, La;La Rioja;99;60;39
1223;Alfacar;Granada;Andalucía;5400;2751;2649
385;Alfafar;Valencia/València;Comunidad Valenciana;20890;10230;10660
4449;Alfafara;Alicante/Alacant;Comunidad Valenciana;410;202;208
2070;Alfajarín;Zaragoza;Aragón;2315;1191;1124
4112;Alfambra;Teruel;Aragón;508;264;244
2642;Alfamén;Zaragoza;Aragón;1446;756;690
6361;Alfántega;Huesca;Aragón;130;66;64
4591;Alfara de Carles;Tarragona;Cataluña;377;199;178
3979;Alfara de la Baronia;Valencia/València;Comunidad Valenciana;557;272;285
1679;Alfara del Patriarca;Valencia/València;Comunidad Valenciana;3310;1604;1706
6376;Alfaraz de Sayago;Zamora;Castilla y León;129;74;55
3037;Alfarnate;Málaga;Andalucía;1069;546;523
4589;Alfarnatejo;Málaga;Andalucía;377;193;184
787;Alfaro;Rioja, La;La Rioja;9476;4751;4725
2552;Alfarp;Valencia/València;Comunidad Valenciana;1544;801;743
1854;Alfarràs;Lleida;Cataluña;2797;1459;1338
2846;Alfarrasí;Valencia/València;Comunidad Valenciana;1225;607;618
394;Alfàs del Pi, l';Alicante/Alacant;Comunidad Valenciana;20482;10187;10295
4363;Alfauir;Valencia/València;Comunidad Valenciana;437;223;214
4915;Alfés;Lleida;Cataluña;312;162;150
3333;Alfondeguilla;Castellón/Castelló;Comunidad Valenciana;866;440;426
2373;Alforja;Tarragona;Cataluña;1801;921;880
7256;Alforque;Zaragoza;Aragón;68;35;33
2446;Alfoz;Lugo;Galicia;1688;812;876
7130;Alfoz de Bricia;Burgos;Castilla y León;76;47;29
2018;Alfoz de Lloredo;Cantabria;Cantabria;2416;1249;1167
2178;Alfoz de Quintanadueñas;Burgos;Castilla y León;2114;1123;991
6769;Alfoz de Santa Gadea;Burgos;Castilla y León;101;58;43
503;Algaba, La;Sevilla;Andalucía;16374;8123;8251
5033;Algadefe;León;Castilla y León;289;151;138
1183;Algaida;Balears, Illes;Islas Baleares;5642;2882;2760
2806;Algámitas;Sevilla;Andalucía;1255;643;612
2660;Algar;Cádiz;Andalucía;1413;721;692
7486;Algar de Mesa;Guadalajara;Castilla-La Mancha;55;39;16
4202;Algar de Palancia;Valencia/València;Comunidad Valenciana;481;255;226
1973;Algarinejo;Granada;Andalucía;2520;1290;1230
7967;Algarra;Cuenca;Castilla-La Mancha;26;13;13
1073;Algarrobo;Málaga;Andalucía;6444;3238;3206
3448;Algatocín;Málaga;Andalucía;793;410;383
54;Algeciras;Cádiz;Andalucía;121957;60120;61837
288;Algemesí;Valencia/València;Comunidad Valenciana;27331;13552;13779
4546;Algerri;Lleida;Cataluña;386;206;180
391;Algete;Madrid;Comunidad de Madrid;20611;10106;10505
3118;Algímia d'Alfara;Valencia/València;Comunidad Valenciana;1011;507;504
5187;Algimia de Almonacid;Castellón/Castelló;Comunidad Valenciana;263;149;114
592;Alginet;Valencia/València;Comunidad Valenciana;13380;6755;6625
1193;Algodonales;Cádiz;Andalucía;5550;2824;2726
6178;Algodre;Zamora;Castilla y León;148;78;70
7222;Algora;Guadalajara;Castilla-La Mancha;70;45;25
1799;Algorfa;Alicante/Alacant;Comunidad Valenciana;2935;1461;1474
1790;Alguaire;Lleida;Cataluña;2971;1562;1409
778;Alguazas;Murcia;Región de Murcia;9638;4957;4681
2731;Algueña;Alicante/Alacant;Comunidad Valenciana;1336;668;668
3698;Alhabia;Almería;Andalucía;671;351;320
1586;Alhama de Almería;Almería;Andalucía;3641;1829;1812
3101;Alhama de Aragón;Zaragoza;Aragón;1020;537;483
1134;Alhama de Granada;Granada;Andalucía;5979;3204;2775
365;Alhama de Murcia;Murcia;Región de Murcia;22077;11168;10909
3129;Alhambra;Ciudad Real;Castilla-La Mancha;1002;506;496
173;Alhaurín de la Torre;Málaga;Andalucía;40345;20047;20298
319;Alhaurín el Grande;Málaga;Andalucía;24705;12344;12361
798;Alhendín;Granada;Andalucía;9349;4721;4628
6056;Alhóndiga;Guadalajara;Castilla-La Mancha;157;91;66
3379;Alía;Cáceres;Extremadura;834;421;413
4753;Aliaga;Teruel;Aragón;341;188;153
3762;Aliaguilla;Cuenca;Castilla-La Mancha;642;331;311
11;Alicante/Alacant;Alicante/Alacant;Comunidad Valenciana;334887;162191;172696
5599;Alicún;Almería;Andalucía;206;110;96
4205;Alicún de Ortega;Granada;Andalucía;480;238;242
3750;Alija del Infantado;León;Castilla y León;647;323;324
5111;Alins;Lleida;Cataluña;276;144;132
4353;Alió;Tarragona;Cataluña;439;208;231
8095;Alique;Guadalajara;Castilla-La Mancha;14;7;7
2341;Aliseda;Cáceres;Extremadura;1835;934;901
8048;Aliud;Soria;Castilla y León;20;15;5
377;Aljaraque;Huelva;Andalucía;21260;10594;10666
5180;Aljucén;Badajoz;Extremadura;264;146;118
4633;Alkiza;Gipuzkoa;País Vasco;367;178;189
2478;Allande;Asturias;Principado de Asturias;1648;833;815
1106;Allariz;Ourense;Galicia;6188;3109;3079
6412;Allepuz;Teruel;Aragón;125;63;62
718;Aller;Asturias;Principado de Asturias;10613;5248;5365
3324;Allín/Allin;Navarra;Navarra;872;465;407
3185;Allo;Navarra;Navarra;968;481;487
3976;Alloza;Teruel;Aragón;558;292;266
7972;Allueva;Teruel;Aragón;26;17;9
1030;Almacelles;Lleida;Cataluña;6791;3584;3207
2366;Almáchar;Málaga;Andalucía;1811;944;867
1240;Almadén;Ciudad Real;Castilla-La Mancha;5312;2536;2776
2712;Almadén de la Plata;Sevilla;Andalucía;1355;696;659
4437;Almadenejos;Ciudad Real;Castilla-La Mancha;415;217;198
7437;Almadrones;Guadalajara;Castilla-La Mancha;57;38;19
839;Almagro;Ciudad Real;Castilla-La Mancha;8896;4377;4519
5749;Almajano;Soria;Castilla y León;187;98;89
6350;Almaluez;Soria;Castilla y León;132;74;58
324;Almansa;Albacete;Castilla-La Mancha;24419;12167;12252
3940;Almanza;León;Castilla y León;574;327;247
2415;Almaraz;Cáceres;Extremadura;1744;895;849
4473;Almaraz de Duero;Zamora;Castilla y León;407;210;197
4640;Almarcha, La;Cuenca;Castilla-La Mancha;365;201;164
2284;Almargen;Málaga;Andalucía;1954;995;959
3893;Almarza;Soria;Castilla y León;591;345;246
7801;Almarza de Cameros;Rioja, La;La Rioja;36;21;15
977;Almàssera;Valencia/València;Comunidad Valenciana;7349;3575;3774
298;Almassora;Castellón/Castelló;Comunidad Valenciana;26270;13224;13046
4935;Almatret;Lleida;Cataluña;307;172;135
1204;Almazán;Soria;Castilla y León;5489;2784;2705
7271;Almazul;Soria;Castilla y León;67;41;26
5253;Almedíjar;Castellón/Castelló;Comunidad Valenciana;254;141;113
4092;Almedina;Ciudad Real;Castilla-La Mancha;516;274;242
2034;Almedinilla;Córdoba;Andalucía;2391;1191;1200
4641;Almegíjar;Granada;Andalucía;365;184;181
4300;Almeida de Sayago;Zamora;Castilla y León;452;240;212
1647;Almenar;Lleida;Cataluña;3398;1791;1607
5438;Almenar de Soria;Soria;Castilla y León;228;135;93
1130;Almenara;Castellón/Castelló;Comunidad Valenciana;5998;3013;2985
8032;Almenara de Adaja;Valladolid;Castilla y León;22;11;11
5198;Almenara de Tormes;Salamanca;Castilla y León;262;146;116
6197;Almendra;Salamanca;Castilla y León;146;85;61
2836;Almendral;Badajoz;Extremadura;1232;606;626
4907;Almendral de la Cañada;Toledo;Castilla-La Mancha;313;162;151
222;Almendralejo;Badajoz;Extremadura;33474;16595;16879
3395;Almendro, El;Huelva;Andalucía;826;438;388
5315;Almendros;Cuenca;Castilla-La Mancha;247;139;108
1118;Almensilla;Sevilla;Andalucía;6080;3043;3037
30;Almería;Almería;Andalucía;198533;96995;101538
5201;Almiserà;Valencia/València;Comunidad Valenciana;262;137;125
7987;Almochuel;Zaragoza;Aragón;25;12;13
5918;Almócita;Almería;Andalucía;169;88;81
1125;Almodóvar del Campo;Ciudad Real;Castilla-La Mancha;6027;3027;3000
4529;Almodóvar del Pinar;Cuenca;Castilla-La Mancha;390;216;174
911;Almodóvar del Río;Córdoba;Andalucía;7937;3963;3974
1561;Almogía;Málaga;Andalucía;3715;1922;1793
2766;Almoguera;Guadalajara;Castilla-La Mancha;1289;667;622
8088;Almohaja;Teruel;Aragón;16;11;5
2364;Almoharín;Cáceres;Extremadura;1811;894;917
2019;Almoines;Valencia/València;Comunidad Valenciana;2414;1228;1186
3991;Almolda, La;Zaragoza;Aragón;553;277;276
5336;Almonacid de la Cuba;Zaragoza;Aragón;243;120;123
3566;Almonacid de la Sierra;Zaragoza;Aragón;735;404;331
3455;Almonacid de Toledo;Toledo;Castilla-La Mancha;790;388;402
3666;Almonacid de Zorita;Guadalajara;Castilla-La Mancha;685;344;341
4408;Almonacid del Marquesado;Cuenca;Castilla-La Mancha;425;218;207
2359;Almonaster la Real;Huelva;Andalucía;1819;978;841
332;Almonte;Huelva;Andalucía;24191;11686;12505
388;Almoradí;Alicante/Alacant;Comunidad Valenciana;20803;10510;10293
2185;Almorox;Toledo;Castilla-La Mancha;2105;1104;1001
2716;Almoster;Tarragona;Cataluña;1351;680;671
6559;Almudaina;Alicante/Alacant;Comunidad Valenciana;113;57;56
2039;Almudévar;Huesca;Aragón;2379;1214;1165
909;Almunia de Doña Godina, La;Zaragoza;Aragón;7951;4089;3862
3732;Almunia de San Juan;Huesca;Aragón;658;339;319
4269;Almuniente;Huesca;Aragón;460;238;222
296;Almuñécar;Granada;Andalucía;26514;13079;13435
3482;Almuradiel;Ciudad Real;Castilla-La Mancha;772;383;389
834;Almussafes;Valencia/València;Comunidad Valenciana;8967;4458;4509
7322;Alobras;Teruel;Aragón;64;40;24
5894;Alocén;Guadalajara;Castilla-La Mancha;172;84;88
1814;Alonsotegi;Bizkaia;País Vasco;2907;1427;1480
603;Álora;Málaga;Andalucía;12985;6572;6413
6362;Alòs de Balaguer;Lleida;Cataluña;130;74;56
1506;Alosno;Huelva;Andalucía;3923;1929;1994
614;Alovera;Guadalajara;Castilla-La Mancha;12735;6498;6237
2216;Alozaina;Málaga;Andalucía;2051;1050;1001
2525;Alp;Girona;Cataluña;1580;828;752
5216;Alpandeire;Málaga;Andalucía;260;131;129
7347;Alpanseque;Soria;Castilla y León;62;38;24
3988;Alpartir;Zaragoza;Aragón;555;284;271
556;Alpedrete;Madrid;Comunidad de Madrid;14575;7160;7415
5166;Alpens;Barcelona;Cataluña;266;144;122
8028;Alpeñés;Teruel;Aragón;22;13;9
2101;Alpera;Albacete;Castilla-La Mancha;2265;1174;1091
1096;Alpicat;Lleida;Cataluña;6255;3134;3121
3789;Alpuente;Valencia/València;Comunidad Valenciana;633;347;286
3151;Alpujarra de la Sierra;Granada;Andalucía;989;563;426
4157;Alqueria d'Asnar, l';Alicante/Alacant;Comunidad Valenciana;493;238;255
2612;Alqueria de la Comtessa, l';Valencia/València;Comunidad Valenciana;1476;716;760
1400;Alqueries, les/Alquerías del Niño Perdido;Castellón/Castelló;Comunidad Valenciana;4449;2209;2240
4957;Alquézar;Huesca;Aragón;303;164;139
3869;Alquife;Granada;Andalucía;601;304;297
6409;Alsodux;Almería;Andalucía;125;75;50
4484;Alt Àneu;Lleida;Cataluña;405;231;174
7554;Altable;Burgos;Castilla y León;51;31;20
1254;Altafulla;Tarragona;Cataluña;5243;2555;2688
5714;Altarejos;Cuenca;Castilla-La Mancha;190;101;89
357;Altea;Alicante/Alacant;Comunidad Valenciana;22290;10911;11379
2658;Altorricón;Huesca;Aragón;1417;756;661
5678;Altos, Los;Burgos;Castilla y León;195;111;84
961;Altsasu/Alsasua;Navarra;Navarra;7443;3761;3682
1611;Altura;Castellón/Castelló;Comunidad Valenciana;3528;1822;1706
5792;Altzaga;Gipuzkoa;País Vasco;183;90;93
4368;Altzo;Gipuzkoa;País Vasco;435;226;209
6111;Alustante;Guadalajara;Castilla-La Mancha;153;90;63
162;Alzira;Valencia/València;Comunidad Valenciana;44352;21608;22744
6340;Amavida;Ávila;Castilla y León;132;70;62
7814;Amayuelas de Arriba;Palencia;Castilla y León;35;22;13
5257;Ambel;Zaragoza;Aragón;254;124;130
3890;Ambite;Madrid;Comunidad de Madrid;592;296;296
2080;Amer;Girona;Cataluña;2298;1122;1176
235;Ames;Coruña, A;Galicia;31793;15236;16557
3588;Améscoa Baja;Navarra;Navarra;724;393;331
1032;Ametlla de Mar, L';Tarragona;Cataluña;6787;3384;3403
868;Ametlla del Vallès, L';Barcelona;Cataluña;8462;4277;4185
6657;Ameyugo;Burgos;Castilla y León;107;55;52
3266;Amezketa;Gipuzkoa;País Vasco;921;497;424
3720;Amieva;Asturias;Principado de Asturias;661;378;283
2089;Amoeiro;Ourense;Galicia;2280;1140;1140
424;Amorebieta-Etxano;Bizkaia;País Vasco;19339;9531;9808
4453;Amoroto;Bizkaia;País Vasco;410;208;202
1709;Ampolla, L';Tarragona;Cataluña;3205;1631;1574
389;Amposta;Tarragona;Cataluña;20738;10449;10289
3858;Ampudia;Palencia;Castilla y León;605;310;295
1424;Ampuero;Cantabria;Cantabria;4288;2166;2122
732;Amurrio;Araba/Álava;País Vasco;10350;5100;5250
4415;Amusco;Palencia;Castilla y León;423;237;186
6744;Amusquillo;Valladolid;Castilla y León;103;65;38
7948;Anadón;Teruel;Aragón;28;18;10
6375;Anaya;Segovia;Castilla y León;129;62;67
5630;Anaya de Alba;Salamanca;Castilla y León;201;118;83
2784;Anchuelo;Madrid;Comunidad de Madrid;1271;657;614
4820;Anchuras;Ciudad Real;Castilla-La Mancha;327;164;163
4773;Ancín/Antzin;Navarra;Navarra;337;192;145
4334;Andavías;Zamora;Castilla y León;444;227;217
4866;Andilla;Valencia/València;Comunidad Valenciana;319;202;117
554;Andoain;Gipuzkoa;País Vasco;14637;7248;7389
958;Andorra;Teruel;Aragón;7472;3773;3699
1875;Andosilla;Navarra;Navarra;2743;1397;1346
681;Andratx;Balears, Illes;Islas Baleares;11271;5625;5646
198;Andújar;Jaén;Andalucía;36793;17978;18815
6694;Anento;Zaragoza;Aragón;106;68;38
1187;Anglès;Girona;Cataluña;5599;2780;2819
2702;Anglesola;Lleida;Cataluña;1363;682;681
8111;Angón;Guadalajara;Castilla-La Mancha;10;8;2
4378;Anguciana;Rioja, La;La Rioja;433;236;197
4685;Angüés;Huesca;Aragón;354;189;165
4146;Anguiano;Rioja, La;La Rioja;497;282;215
6072;Anguita;Guadalajara;Castilla-La Mancha;156;79;77
6300;Anguix;Burgos;Castilla y León;136;77;59
5161;Anievas;Cantabria;Cantabria;267;141;126
3624;Aniñón;Zaragoza;Aragón;706;383;323
1919;Anna;Valencia/València;Comunidad Valenciana;2628;1322;1306
2191;Anoeta;Gipuzkoa;País Vasco;2090;1088;1002
7575;Anquela del Ducado;Guadalajara;Castilla-La Mancha;50;31;19
7993;Anquela del Pedregal;Guadalajara;Castilla-La Mancha;24;16;8
4482;Ansó;Huesca;Aragón;405;204;201
707;Ansoáin/Antsoain;Navarra;Navarra;10833;5312;5521
1712;Antas;Almería;Andalucía;3182;1614;1568
2271;Antas de Ulla;Lugo;Galicia;1976;966;1010
2898;Antella;Valencia/València;Comunidad Valenciana;1175;571;604
170;Antequera;Málaga;Andalucía;41239;20180;21059
625;Antigua;Palmas, Las;Canarias;12461;6601;5860
4662;Antigua, La;León;Castilla y León;360;208;152
4653;Antigüedad;Palencia;Castilla y León;363;191;172
6267;Antillón;Huesca;Aragón;140;70;70
2175;Antzuola;Gipuzkoa;País Vasco;2126;1059;1067
4194;Anue;Navarra;Navarra;482;257;225
6070;Añana;Araba/Álava;País Vasco;156;95;61
7122;Añe;Segovia;Castilla y León;77;45;32
5565;Añón de Moncayo;Zaragoza;Aragón;212;129;83
2565;Añora;Córdoba;Andalucía;1527;752;775
3926;Añorbe;Navarra;Navarra;581;317;264
1271;Añover de Tajo;Toledo;Castilla-La Mancha;5154;2620;2534
6994;Añover de Tormes;Salamanca;Castilla y León;86;46;40
1895;Aoiz/Agoitz;Navarra;Navarra;2695;1376;1319
4673;Arabayona de Mógica;Salamanca;Castilla y León;357;202;155
894;Aracena;Huelva;Andalucía;8107;3984;4123
1192;Arafo;Santa Cruz de Tenerife;Canarias;5551;2731;2820
6536;Aragüés del Puerto;Huesca;Aragón;115;65;50
420;Arahal;Sevilla;Andalucía;19526;9677;9849
7910;Arahuetes;Segovia;Castilla y León;30;22;8
4103;Araitz;Navarra;Navarra;512;285;227
6030;Arakaldo;Bizkaia;País Vasco;159;79;80
3249;Arakil;Navarra;Navarra;933;487;446
5640;Arama;Gipuzkoa;País Vasco;200;99;101
2622;Aramaio;Araba/Álava;País Vasco;1467;764;703
7202;Aranarache/Aranaratxe;Navarra;Navarra;72;42;30
6967;Arancón;Soria;Castilla y León;88;59;29
226;Aranda de Duero;Burgos;Castilla y León;32856;15941;16915
6131;Aranda de Moncayo;Zaragoza;Aragón;152;96;56
4962;Arándiga;Zaragoza;Aragón;302;159;143
6021;Arandilla;Burgos;Castilla y León;160;101;59
8127;Arandilla del Arroyo;Cuenca;Castilla-La Mancha;7;3;4
2330;Aranga;Coruña, A;Galicia;1849;964;885
705;Aranguren;Navarra;Navarra;10859;5468;5391
125;Aranjuez;Madrid;Comunidad de Madrid;59607;28978;30629
6524;Arano;Navarra;Navarra;116;63;53
3877;Arantza;Navarra;Navarra;597;316;281
4515;Arantzazu;Bizkaia;País Vasco;395;191;204
4572;Aranzueque;Guadalajara;Castilla-La Mancha;380;204;176
6150;Arañuel;Castellón/Castelló;Comunidad Valenciana;150;78;72
3727;Arapiles;Salamanca;Castilla y León;660;355;305
6113;Aras;Navarra;Navarra;153;81;72
4567;Aras de los Olmos;Valencia/València;Comunidad Valenciana;381;215;166
4940;Arauzo de Miel;Burgos;Castilla y León;306;168;138
7406;Arauzo de Salce;Burgos;Castilla y León;58;35;23
7210;Arauzo de Torre;Burgos;Castilla y León;71;43;28
6151;Arbancón;Guadalajara;Castilla-La Mancha;150;89;61
2161;Arbeca;Lleida;Cataluña;2144;1100;1044
8012;Arbeteta;Guadalajara;Castilla-La Mancha;22;17;5
2995;Arbizu;Navarra;Navarra;1104;565;539
1947;Arbo;Pontevedra;Galicia;2580;1328;1252
1200;Arboç, L';Tarragona;Cataluña;5517;2852;2665
1372;Arboleas;Almería;Andalucía;4596;2312;2284
6296;Arbolí;Tarragona;Cataluña;137;79;58
1058;Arbúcies;Girona;Cataluña;6556;3390;3166
2436;Arcas;Cuenca;Castilla-La Mancha;1716;866;850
5197;Arce/Artzi;Navarra;Navarra;262;138;124
6666;Arcediano;Salamanca;Castilla y León;107;58;49
4419;Arcenillas;Zamora;Castilla y León;420;214;206
425;Archena;Murcia;Región de Murcia;19301;10155;9146
4550;Árchez;Málaga;Andalucía;385;202;183
887;Archidona;Málaga;Andalucía;8238;4213;4025
3309;Arcicóllar;Toledo;Castilla-La Mancha;883;437;446
6995;Arco, El;Salamanca;Castilla y León;86;42;44
7721;Arconada;Palencia;Castilla y León;41;25;16
5955;Arcones;Segovia;Castilla y León;166;80;86
2420;Arcos;Burgos;Castilla y León;1734;911;823
2619;Arcos de Jalón;Soria;Castilla y León;1469;761;708
246;Arcos de la Frontera;Cádiz;Andalucía;30700;15318;15382
5492;Arcos de la Polvorosa;Zamora;Castilla y León;221;122;99
7032;Arcos de la Sierra;Cuenca;Castilla-La Mancha;83;47;36
6483;Arcos de las Salinas;Teruel;Aragón;119;68;51
2953;Arcos, Los;Navarra;Navarra;1134;558;576
1982;Ardales;Málaga;Andalucía;2500;1273;1227
7233;Ardisa;Zaragoza;Aragón;70;43;27
3974;Ardón;León;Castilla y León;560;303;257
2865;Areatza;Bizkaia;País Vasco;1201;578;623
6060;Arellano;Navarra;Navarra;157;85;72
4903;Arén;Huesca;Aragón;313;172;141
3172;Arenal, El;Ávila;Castilla y León;973;497;476
3898;Arenales de San Gregorio;Ciudad Real;Castilla-La Mancha;589;300;289
2927;Arenas;Málaga;Andalucía;1156;611;545
2458;Arenas de Iguña;Cantabria;Cantabria;1679;856;823
3117;Arenas de San Juan;Ciudad Real;Castilla-La Mancha;1011;515;496
1081;Arenas de San Pedro;Ávila;Castilla y León;6377;3105;3272
3707;Arenas del Rey;Granada;Andalucía;666;366;300
8039;Arenillas;Soria;Castilla y León;21;11;10
5824;Arenillas de Riopisuerga;Burgos;Castilla y León;180;104;76
5574;Arens de Lledó;Teruel;Aragón;211;108;103
518;Arenys de Mar;Barcelona;Cataluña;15776;7683;8093
838;Arenys de Munt;Barcelona;Cataluña;8931;4483;4448
5422;Arenzana de Abajo;Rioja, La;La Rioja;230;118;112
7924;Arenzana de Arriba;Rioja, La;La Rioja;29;20;9
1167;Ares;Coruña, A;Galicia;5732;2825;2907
5758;Ares del Maestrat;Castellón/Castelló;Comunidad Valenciana;186;107;79
5097;Areso;Navarra;Navarra;279;142;137
998;Aretxabaleta;Gipuzkoa;País Vasco;7128;3577;3551
7181;Arevalillo;Ávila;Castilla y León;73;35;38
8047;Arevalillo de Cega;Segovia;Castilla y León;20;12;8
904;Arévalo;Ávila;Castilla y León;7986;3877;4109
7110;Arévalo de la Sierra;Soria;Castilla y León;78;49;29
1025;Argamasilla de Alba;Ciudad Real;Castilla-La Mancha;6838;3418;3420
1136;Argamasilla de Calatrava;Ciudad Real;Castilla-La Mancha;5943;2994;2949
133;Arganda del Rey;Madrid;Comunidad de Madrid;55389;27771;27618
3413;Arganza;León;Castilla y León;816;407;409
7079;Argañín;Zamora;Castilla y León;80;40;40
6862;Argavieso;Huesca;Aragón;95;56;39
7314;Argecilla;Guadalajara;Castilla-La Mancha;64;44;20
4507;Argelaguer;Girona;Cataluña;397;205;192
6491;Argelita;Castellón/Castelló;Comunidad Valenciana;118;72;46
5517;Argençola;Barcelona;Cataluña;217;110;107
5682;Argente;Teruel;Aragón;195;96;99
6423;Argentera, L';Tarragona;Cataluña;124;70;54
627;Argentona;Barcelona;Cataluña;12452;6132;6320
1074;Argés;Toledo;Castilla-La Mancha;6418;3197;3221
2412;Argoños;Cantabria;Cantabria;1748;898;850
2096;Arguedas;Navarra;Navarra;2272;1155;1117
6388;Arguis;Huesca;Aragón;127;72;55
6302;Arguisuelas;Cuenca;Castilla-La Mancha;136;74;62
5342;Argujillo;Zamora;Castilla y León;242;122;120
7562;Aria;Navarra;Navarra;51;29;22
3330;Ariany;Balears, Illes;Islas Baleares;868;453;415
7848;Aribe;Navarra;Navarra;33;19;14
903;Arico;Santa Cruz de Tenerife;Canarias;7988;4151;3837
6366;Arija;Burgos;Castilla y León;129;68;61
3589;Ariño;Teruel;Aragón;724;365;359
2981;Ariza;Zaragoza;Aragón;1115;575;540
1195;Arjona;Jaén;Andalucía;5542;2730;2812
1594;Arjonilla;Jaén;Andalucía;3575;1812;1763
4500;Arlanzón;Burgos;Castilla y León;400;243;157
7392;Armallones;Guadalajara;Castilla-La Mancha;59;32;27
7524;Armañanzas;Navarra;Navarra;53;28;25
3255;Armentera, L';Girona;Cataluña;930;461;469
5658;Armenteros;Salamanca;Castilla y León;198;111;87
334;Armilla;Granada;Andalucía;24174;11987;12187
5445;Armiñón;Araba/Álava;País Vasco;227;119;108
5505;Armuña;Segovia;Castilla y León;219;121;98
4960;Armuña de Almanzora;Almería;Andalucía;302;144;158
5321;Armuña de Tajuña;Guadalajara;Castilla-La Mancha;246;134;112
4423;Arnedillo;Rioja, La;La Rioja;419;201;218
546;Arnedo;Rioja, La;La Rioja;14875;7415;7460
4288;Arnes;Tarragona;Cataluña;455;224;231
3133;Arnoia, A;Ourense;Galicia;1000;497;503
2186;Arnuero;Cantabria;Cantabria;2103;1062;1041
1742;Aroche;Huelva;Andalucía;3073;1528;1545
91;Arona;Santa Cruz de Tenerife;Canarias;81216;41283;39933
6516;Arquillinos;Zamora;Castilla y León;117;59;58
2421;Arquillos;Jaén;Andalucía;1734;866;868
5529;Arrabalde;Zamora;Castilla y León;216;107;109
3581;Arraia-Maeztu;Araba/Álava;País Vasco;726;403;323
7978;Arrancacepas;Cuenca;Castilla-La Mancha;25;13;12
3182;Arrankudiaga;Bizkaia;País Vasco;968;479;489
366;Arrasate/Mondragón;Gipuzkoa;País Vasco;22001;10814;11187
4425;Arratzu;Bizkaia;País Vasco;418;203;215
3159;Arratzua-Ubarrundia;Araba/Álava;País Vasco;980;529;451
7594;Arraya de Oca;Burgos;Castilla y León;49;29;20
121;Arrecife;Palmas, Las;Canarias;62988;31512;31476
4297;Arredondo;Cantabria;Cantabria;452;253;199
7302;Arres;Lleida;Cataluña;65;42;23
1474;Arriate;Málaga;Andalucía;4102;2033;2069
3909;Arrieta;Bizkaia;País Vasco;586;300;286
637;Arrigorriaga;Bizkaia;País Vasco;12160;5923;6237
4326;Arroba de los Montes;Ciudad Real;Castilla-La Mancha;446;241;205
3056;Arróniz;Navarra;Navarra;1051;559;492
408;Arroyo de la Encomienda;Valladolid;Castilla y León;20179;10171;10008
1157;Arroyo de la Luz;Cáceres;Extremadura;5811;2889;2922
8013;Arroyo de las Fraguas;Guadalajara;Castilla-La Mancha;22;12;10
1472;Arroyo de San Serván;Badajoz;Extremadura;4107;2085;2022
2085;Arroyo del Ojanco;Jaén;Andalucía;2288;1158;1130
238;Arroyomolinos;Madrid;Comunidad de Madrid;31396;15701;15695
3442;Arroyomolinos;Cáceres;Extremadura;797;413;384
4336;Arroyomolinos de la Vera;Cáceres;Extremadura;443;223;220
3213;Arroyomolinos de León;Huelva;Andalucía;953;493;460
6622;Arruazu;Navarra;Navarra;110;58;52
4119;Arrúbal;Rioja, La;La Rioja;506;271;235
7018;Arsèguel;Lleida;Cataluña;84;48;36
920;Artà;Balears, Illes;Islas Baleares;7845;3949;3896
2464;Artajona;Navarra;Navarra;1675;854;821
2289;Artana;Castellón/Castelló;Comunidad Valenciana;1947;992;955
6525;Artazu;Navarra;Navarra;116;61;55
3557;Artea;Bizkaia;País Vasco;736;366;370
229;Arteixo;Coruña, A;Galicia;32262;15976;16286
3039;Artenara;Palmas, Las;Canarias;1069;589;480
1172;Artés;Barcelona;Cataluña;5698;2868;2830
2585;Artesa de Lleida;Lleida;Cataluña;1504;789;715
1637;Artesa de Segre;Lleida;Cataluña;3432;1766;1666
7080;Artieda;Zaragoza;Aragón;80;47;33
3594;Artzentales;Bizkaia;País Vasco;721;385;336
2356;Artziniega;Araba/Álava;País Vasco;1821;906;915
188;Arucas;Palmas, Las;Canarias;38138;19000;19138
1123;Arzúa;Coruña, A;Galicia;6041;3012;3029
2471;Ascó;Tarragona;Cataluña;1660;856;804
6632;Asín;Zaragoza;Aragón;110;58;52
5463;Aspa;Lleida;Cataluña;224;113;111
5318;Aspariegos;Zamora;Castilla y León;247;115;132
2498;Asparrena;Araba/Álava;País Vasco;1614;826;788
390;Aspe;Alicante/Alacant;Comunidad Valenciana;20714;10435;10279
2547;Asteasu;Gipuzkoa;País Vasco;1551;808;743
1063;Astigarraga;Gipuzkoa;País Vasco;6532;3312;3220
456;Astillero, El;Cantabria;Cantabria;18111;8853;9258
702;Astorga;León;Castilla y León;10867;5113;5754
3141;Astudillo;Palencia;Castilla y León;995;502;493
5144;Asturianos;Zamora;Castilla y León;271;137;134
5936;Atajate;Málaga;Andalucía;168;91;77
4964;Atalaya;Badajoz;Extremadura;301;154;147
6581;Atalaya del Cañavate;Cuenca;Castilla-La Mancha;112;58;54
6552;Atalaya, La;Salamanca;Castilla y León;114;63;51
6786;Atanzón;Guadalajara;Castilla-La Mancha;100;66;34
5990;Atapuerca;Burgos;Castilla y León;162;91;71
3922;Ataquines;Valladolid;Castilla y León;583;318;265
440;Atarfe;Granada;Andalucía;18706;9320;9386
2444;Ataun;Gipuzkoa;País Vasco;1693;879;814
6950;Atazar, El;Madrid;Comunidad de Madrid;89;48;41
6147;Atea;Zaragoza;Aragón;151;93;58
2399;Ateca;Zaragoza;Aragón;1762;916;846
5536;Atez/Atetz;Navarra;Navarra;215;119;96
4481;Atienza;Guadalajara;Castilla-La Mancha;405;228;177
2698;Atxondo;Bizkaia;País Vasco;1366;685;681
2912;Atzeneta d'Albaida;Valencia/València;Comunidad Valenciana;1165;584;581
2779;Atzeneta del Maestrat;Castellón/Castelló;Comunidad Valenciana;1276;649;627
3792;Atzúbia, l';Alicante/Alacant;Comunidad Valenciana;632;325;307
3737;Aulesti;Bizkaia;País Vasco;654;323;331
6243;Auñón;Guadalajara;Castilla-La Mancha;142;80;62
5414;Auritz/Burguete;Navarra;Navarra;231;118;113
3476;Ausejo;Rioja, La;La Rioja;780;414;366
6954;Ausejo de la Sierra;Soria;Castilla y León;89;47;42
6330;Ausines, Los;Burgos;Castilla y León;133;80;53
5480;Autilla del Pino;Palencia;Castilla y León;222;119;103
6381;Autillo de Campos;Palencia;Castilla y León;128;69;59
1381;Autol;Rioja, La;La Rioja;4512;2231;2281
6985;Aveinte;Ávila;Castilla y León;86;50;36
7988;Avellaneda;Ávila;Castilla y León;24;14;10
4310;Avellanes i Santa Linya, Les;Lleida;Cataluña;449;259;190
6651;Avellanosa de Muñó;Burgos;Castilla y León;108;60;48
2124;Avià;Barcelona;Cataluña;2226;1121;1105
130;Ávila;Ávila;Castilla y León;57744;27474;30270
94;Avilés;Asturias;Principado de Asturias;78182;36993;41189
2092;Avinyó;Barcelona;Cataluña;2275;1127;1148
2503;Avinyonet de Puigventós;Girona;Cataluña;1610;796;814
2442;Avinyonet del Penedès;Barcelona;Cataluña;1701;903;798
2376;Avión;Ourense;Galicia;1795;825;970
1786;Ayala/Aiara;Araba/Álava;País Vasco;2974;1500;1474
383;Ayamonte;Huelva;Andalucía;20946;10492;10454
2045;Ayegui/Aiegi;Navarra;Navarra;2366;1230;1136
3119;Ayerbe;Huesca;Aragón;1009;500;509
2869;Ayllón;Segovia;Castilla y León;1196;617;579
3831;Ayna;Albacete;Castilla-La Mancha;616;327;289
6031;Ayódar;Castellón/Castelló;Comunidad Valenciana;159;86;73
4933;Ayoó de Vidriales;Zamora;Castilla y León;308;157;151
1241;Ayora;Valencia/València;Comunidad Valenciana;5312;2629;2683
7540;Ayuela;Palencia;Castilla y León;52;33;19
1526;Azagra;Navarra;Navarra;3843;1947;1896
6937;Azaila;Teruel;Aragón;90;46;44
5934;Azanuy-Alins;Huesca;Aragón;168;80;88
5908;Azara;Huesca;Aragón;171;86;85
661;Azkoitia;Gipuzkoa;País Vasco;11633;5783;5850
6226;Azlor;Huesca;Aragón;143;65;78
1374;Aznalcázar;Sevilla;Andalucía;4586;2318;2268
1116;Aznalcóllar;Sevilla;Andalucía;6091;3102;2989
5537;Azofra;Rioja, La;La Rioja;215;117;98
544;Azpeitia;Gipuzkoa;País Vasco;14936;7468;7468
919;Azuaga;Badajoz;Extremadura;7853;3893;3960
4017;Azuara;Zaragoza;Aragón;540;303;237
4890;Azuébar;Castellón/Castelló;Comunidad Valenciana;315;165;150
7885;Azuelo;Navarra;Navarra;31;12;19
210;Azuqueca de Henares;Guadalajara;Castilla-La Mancha;35009;17744;17265
5042;Azután;Toledo;Castilla-La Mancha;288;144;144
3302;Babilafuente;Salamanca;Castilla y León;885;467;418
5319;Bacares;Almería;Andalucía;246;130;116
43;Badajoz;Badajoz;Extremadura;150702;73078;77624
22;Badalona;Barcelona;Cataluña;220440;108509;111931
4195;Badarán;Rioja, La;La Rioja;482;249;233
8060;Bádenas;Teruel;Aragón;19;12;7
591;Badia del Vallès;Barcelona;Cataluña;13380;6567;6813
1740;Badolatosa;Sevilla;Andalucía;3078;1589;1489
7009;Badules;Zaragoza;Aragón;85;47;38
6717;Baélls;Huesca;Aragón;104;59;45
426;Baena;Córdoba;Andalucía;19284;9829;9455
516;Baeza;Jaén;Andalucía;15841;7841;8000
2168;Bagà;Barcelona;Cataluña;2138;1064;1074
5049;Báguena;Teruel;Aragón;287;161;126
8081;Bagüés;Zaragoza;Aragón;17;10;7
6655;Bahabón;Valladolid;Castilla y León;108;50;58
7052;Bahabón de Esgueva;Burgos;Castilla y León;81;45;36
7464;Baides;Guadalajara;Castilla-La Mancha;56;29;27
467;Bailén;Jaén;Andalucía;17667;8773;8894
5163;Bailo;Huesca;Aragón;267;160;107
641;Baiona;Pontevedra;Galicia;12122;5974;6148
4780;Baix Pallars;Lleida;Cataluña;335;182;153
4656;Bakaiku;Navarra;Navarra;362;188;174
1898;Bakio;Bizkaia;País Vasco;2688;1357;1331
480;Balaguer;Lleida;Cataluña;17162;8746;8416
1769;Balanegra;Almería;Andalucía;3009;1583;1426
2061;Balazote;Albacete;Castilla-La Mancha;2334;1189;1145
4837;Balbases, Los;Burgos;Castilla y León;324;177;147
5029;Balboa;León;Castilla y León;290;158;132
8089;Balconchán;Zaragoza;Aragón;16;6;10
7135;Baldellou;Huesca;Aragón;76;44;32
2825;Baleira;Lugo;Galicia;1241;660;581
1532;Balenyà;Barcelona;Cataluña;3821;1928;1893
6287;Baliarrain;Gipuzkoa;País Vasco;138;74;64
4480;Ballestero, El;Albacete;Castilla-La Mancha;405;207;198
4603;Ballesteros de Calatrava;Ciudad Real;Castilla-La Mancha;373;186;187
3423;Ballobar;Huesca;Aragón;812;423;389
932;Balmaseda;Bizkaia;País Vasco;7697;3717;3980
6352;Balones;Alicante/Alacant;Comunidad Valenciana;131;73;58
6041;Balsa de Ves;Albacete;Castilla-La Mancha;158;91;67
1716;Balsareny;Barcelona;Cataluña;3159;1562;1597
2876;Baltanás;Palencia;Castilla y León;1191;623;568
3195;Baltar;Ourense;Galicia;962;521;441
4998;Banastás;Huesca;Aragón;295;153;142
2564;Bande;Ourense;Galicia;1528;748;780
4096;Banyalbufar;Balears, Illes;Islas Baleares;515;272;243
1005;Banyeres de Mariola;Alicante/Alacant;Comunidad Valenciana;7068;3538;3530
1715;Banyeres del Penedès;Tarragona;Cataluña;3170;1612;1558
416;Banyoles;Girona;Cataluña;19826;9873;9953
1632;Baña, A;Coruña, A;Galicia;3450;1628;1822
5345;Bañares;Rioja, La;La Rioja;241;128;113
734;Bañeza, La;León;Castilla y León;10338;4977;5361
4944;Bañobárez;Salamanca;Castilla y León;305;156;149
6218;Bañón;Teruel;Aragón;144;79;65
5020;Baños de Ebro/Mañueta;Araba/Álava;País Vasco;291;163;128
1944;Baños de la Encina;Jaén;Andalucía;2582;1332;1250
2569;Baños de Molgas;Ourense;Galicia;1519;761;758
3512;Baños de Montemayor;Cáceres;Extremadura;759;354;405
2527;Baños de Río Tobía;Rioja, La;La Rioja;1579;783;796
6923;Baños de Rioja;Rioja, La;La Rioja;91;53;38
8052;Baños de Tajo;Guadalajara;Castilla-La Mancha;19;14;5
4838;Baños de Valdearados;Burgos;Castilla y León;324;192;132
8096;Bañuelos;Guadalajara;Castilla-La Mancha;14;12;2
7782;Bañuelos de Bureba;Burgos;Castilla y León;37;22;15
7907;Baquerín de Campos;Palencia;Castilla y León;30;18;12
3252;Barajas de Melo;Cuenca;Castilla-La Mancha;932;491;441
63;Barakaldo;Bizkaia;País Vasco;100881;48681;52200
1953;Baralla;Lugo;Galicia;2556;1351;1205
406;Barañáin/Barañain;Navarra;Navarra;20199;9772;10427
6317;Baraona;Soria;Castilla y León;135;76;59
3817;Barásoain;Navarra;Navarra;621;329;292
689;Barbadás;Ourense;Galicia;11037;5367;5670
4492;Barbadillo;Salamanca;Castilla y León;402;215;187
6658;Barbadillo de Herreros;Burgos;Castilla y León;107;67;40
6239;Barbadillo del Mercado;Burgos;Castilla y León;142;78;64
7247;Barbadillo del Pez;Burgos;Castilla y León;68;40;28
7188;Barbalos;Salamanca;Castilla y León;73;41;32
7491;Barbarin;Navarra;Navarra;55;27;28
485;Barbastro;Huesca;Aragón;16979;8256;8723
353;Barbate;Cádiz;Andalucía;22518;11303;11215
3313;Barbens;Lleida;Cataluña;878;467;411
4231;Barberà de la Conca;Tarragona;Cataluña;473;257;216
225;Barberà del Vallès;Barcelona;Cataluña;33091;16300;16791
5013;Bárboles;Zaragoza;Aragón;293;157;136
6049;Barbolla;Segovia;Castilla y León;158;87;71
7105;Barbués;Huesca;Aragón;78;47;31
6842;Barbuñales;Huesca;Aragón;96;48;48
6824;Barca;Soria;Castilla y León;98;62;36
6737;Bárcabo;Huesca;Aragón;103;57;46
1617;Barcarrota;Badajoz;Extremadura;3510;1777;1733
2;Barcelona;Barcelona;Cataluña;1636762;775619;861143
7396;Bárcena de Campos;Palencia;Castilla y León;59;26;33
1435;Bárcena de Cicero;Cantabria;Cantabria;4246;2187;2059
3682;Bárcena de Pie de Concha;Cantabria;Cantabria;678;341;337
7646;Barceo;Salamanca;Castilla y León;46;29;17
6945;Barchín del Hoyo;Cuenca;Castilla-La Mancha;89;57;32
6908;Barcial de la Loma;Valladolid;Castilla y León;92;52;40
5302;Barcial del Barco;Zamora;Castilla y León;249;132;117
3325;Barcience;Toledo;Castilla-La Mancha;872;458;414
2071;Barco de Ávila, El;Ávila;Castilla y León;2312;1123;1189
590;Barco de Valdeorras, O;Ourense;Galicia;13395;6512;6883
8024;Barcones;Soria;Castilla y León;22;15;7
5258;Bardallur;Zaragoza;Aragón;254;122;132
2286;Bareyo;Cantabria;Cantabria;1950;985;965
738;Bargas;Toledo;Castilla-La Mancha;10332;5174;5158
5233;Bargota;Navarra;Navarra;257;123;134
5545;Barillas;Navarra;Navarra;214;115;99
5717;Barjas;León;Castilla y León;190;101;89
2316;Barlovento;Santa Cruz de Tenerife;Canarias;1876;956;920
5376;Baronia de Rialb, La;Lleida;Cataluña;237;121;116
5993;Barracas;Castellón/Castelló;Comunidad Valenciana;162;93;69
6595;Barrachina;Teruel;Aragón;112;60;52
2322;Barraco, El;Ávila;Castilla y León;1861;955;906
4495;Barrado;Cáceres;Extremadura;401;207;194
2343;Barrax;Albacete;Castilla-La Mancha;1833;939;894
1802;Barreiros;Lugo;Galicia;2934;1405;1529
2561;Barrika;Bizkaia;País Vasco;1529;747;782
7838;Barrio de Muñó;Burgos;Castilla y León;33;19;14
8092;Barriopedro;Guadalajara;Castilla-La Mancha;15;11;4
5655;Barrios de Bureba, Los;Burgos;Castilla y León;198;113;85
7457;Barrios de Colina;Burgos;Castilla y León;56;31;25
4896;Barrios de Luna, Los;León;Castilla y León;314;179;135
339;Barrios, Los;Cádiz;Andalucía;23642;11825;11817
1573;Barro;Pontevedra;Galicia;3680;1824;1856
5765;Barromán;Ávila;Castilla y León;185;100;85
4306;Barruecopardo;Salamanca;Castilla y León;450;250;200
2882;Barruelo de Santullán;Palencia;Castilla y León;1186;589;597
7546;Barruelo del Valle;Valladolid;Castilla y León;52;33;19
3307;Barrundia;Araba/Álava;País Vasco;883;491;392
2778;Barx;Valencia/València;Comunidad Valenciana;1277;672;605
2512;Barxeta;Valencia/València;Comunidad Valenciana;1601;825;776
3381;Basaburua;Navarra;Navarra;834;479;355
6117;Basardilla;Segovia;Castilla y León;153;68;85
172;Basauri;Bizkaia;País Vasco;40589;19639;20950
3124;Bàscara;Girona;Cataluña;1004;520;484
5008;Basconcillos del Tozo;Burgos;Castilla y León;293;164;129
6229;Báscones de Ojeda;Palencia;Castilla y León;143;75;68
7991;Bascuñana;Burgos;Castilla y León;24;16;8
8063;Bascuñana de San Pedro;Cuenca;Castilla-La Mancha;18;15;3
5464;Bassella;Lleida;Cataluña;224;112;112
7943;Bastida, La;Salamanca;Castilla y León;28;16;12
2306;Batea;Tarragona;Cataluña;1890;944;946
5064;Baterno;Badajoz;Extremadura;283;151;132
2450;Batres;Madrid;Comunidad de Madrid;1684;861;823
7414;Bausen;Lleida;Cataluña;58;30;28
4876;Bayárcal;Almería;Andalucía;317;171;146
5530;Bayarque;Almería;Andalucía;215;102;113
6248;Bayubas de Abajo;Soria;Castilla y León;142;77;65
7448;Bayubas de Arriba;Soria;Castilla y León;57;34;23
397;Baza;Granada;Andalucía;20412;10137;10275
928;Baztan;Navarra;Navarra;7777;3929;3848
7893;Bea;Teruel;Aragón;31;18;13
4510;Beade;Ourense;Galicia;397;207;190
7785;Beamud;Cuenca;Castilla-La Mancha;37;18;19
3176;Beariz;Ourense;Galicia;971;431;540
1433;Beas;Huelva;Andalucía;4257;2136;2121
3164;Beas de Granada;Granada;Andalucía;977;519;458
4811;Beas de Guadix;Granada;Andalucía;329;169;160
1278;Beas de Segura;Jaén;Andalucía;5130;2683;2447
571;Beasain;Gipuzkoa;País Vasco;13880;6976;6904
5671;Becedas;Ávila;Castilla y León;196;105;91
7010;Becedillas;Ávila;Castilla y León;84;46;38
4013;Beceite;Teruel;Aragón;541;273;268
1850;Becerreá;Lugo;Galicia;2818;1419;1399
3579;Becerril de Campos;Palencia;Castilla y León;727;373;354
1170;Becerril de la Sierra;Madrid;Comunidad de Madrid;5714;2877;2837
5372;Becilla de Valderaduey;Valladolid;Castilla y León;238;136;102
3175;Bédar;Almería;Andalucía;971;491;480
3043;Bedia;Bizkaia;País Vasco;1067;508;559
1913;Bedmar y Garcíez;Jaén;Andalucía;2642;1341;1301
1762;Begíjar;Jaén;Andalucía;3029;1526;1503
1763;Begonte;Lugo;Galicia;3026;1516;1510
1003;Begues;Barcelona;Cataluña;7098;3528;3570
1505;Begur;Girona;Cataluña;3925;1964;1961
5498;Beintza-Labaien;Navarra;Navarra;220;128;92
5053;Beire;Navarra;Navarra;286;151;135
6615;Beires;Almería;Andalucía;110;56;54
6223;Beizama;Gipuzkoa;País Vasco;143;86;57
613;Béjar;Salamanca;Castilla y León;12739;6026;6713
4569;Bejís;Castellón/Castelló;Comunidad Valenciana;380;215;165
1695;Belalcázar;Córdoba;Andalucía;3255;1572;1683
6445;Belascoáin;Navarra;Navarra;122;62;60
5344;Belauntza;Gipuzkoa;País Vasco;241;125;116
7354;Belbimbre;Burgos;Castilla y León;61;34;27
2582;Belchite;Zaragoza;Aragón;1505;756;749
5245;Beleña;Salamanca;Castilla y León;256;129;127
3695;Bèlgida;Valencia/València;Comunidad Valenciana;673;330;343
4064;Belianes;Lleida;Cataluña;525;269;256
4784;Belinchón;Cuenca;Castilla-La Mancha;334;173;161
2068;Bell-lloc d'Urgell;Lleida;Cataluña;2315;1139;1176
5046;Bellaguarda;Lleida;Cataluña;287;152;135
3646;Bellcaire d'Empordà;Girona;Cataluña;693;336;357
2840;Bellcaire d'Urgell;Lleida;Cataluña;1230;627;603
5770;Bellmunt d'Urgell;Lleida;Cataluña;185;89;96
5088;Bellmunt del Priorat;Tarragona;Cataluña;280;145;135
5465;Bello;Teruel;Aragón;224;111;113
7312;Bellprat;Barcelona;Cataluña;64;41;23
1277;Bellpuig;Lleida;Cataluña;5133;2705;2428
1367;Bellreguard;Valencia/València;Comunidad Valenciana;4608;2292;2316
4952;Bellús;Valencia/València;Comunidad Valenciana;304;160;144
2134;Bellvei;Tarragona;Cataluña;2203;1132;1071
2293;Bellver de Cerdanya;Lleida;Cataluña;1937;1009;928
2107;Bellvís;Lleida;Cataluña;2255;1149;1106
1806;Belmez;Córdoba;Andalucía;2923;1418;1505
2537;Bélmez de la Moraleda;Jaén;Andalucía;1567;795;772
2302;Belmonte;Cuenca;Castilla-La Mancha;1903;954;949
7908;Belmonte de Campos;Palencia;Castilla y León;30;15;15
5668;Belmonte de Gracián;Zaragoza;Aragón;197;111;86
2599;Belmonte de Miranda;Asturias;Principado de Asturias;1489;787;702
6569;Belmonte de San José;Teruel;Aragón;113;53;60
2468;Belmonte de Tajo;Madrid;Comunidad de Madrid;1664;865;799
6022;Belmontejo;Cuenca;Castilla-La Mancha;160;92;68
2383;Belorado;Burgos;Castilla y León;1781;914;867
2781;Belver de Cinca;Huesca;Aragón;1275;742;533
5119;Belver de los Montes;Zamora;Castilla y León;275;151;124
2567;Belvís de la Jara;Toledo;Castilla-La Mancha;1522;764;758
3584;Belvís de Monroy;Cáceres;Extremadura;725;381;344
853;Bembibre;León;Castilla y León;8705;4220;4485
2970;Benabarre;Huesca;Aragón;1124;590;534
989;Benacazón;Sevilla;Andalucía;7241;3660;3581
5535;Benadalid;Málaga;Andalucía;215;108;107
7206;Benafarces;Valladolid;Castilla y León;72;35;37
6120;Benafer;Castellón/Castelló;Comunidad Valenciana;152;81;71
6242;Benafigos;Castellón/Castelló;Comunidad Valenciana;142;80;62
5703;Benagéber;Valencia/València;Comunidad Valenciana;192;110;82
695;Benaguasil;Valencia/València;Comunidad Valenciana;10988;5625;5363
1413;Benahadux;Almería;Andalucía;4382;2160;2222
896;Benahavís;Málaga;Andalucía;8085;4043;4042
4358;Benalauría;Málaga;Andalucía;438;231;207
111;Benalmádena;Málaga;Andalucía;68128;33521;34607
1675;Benalúa;Granada;Andalucía;3318;1644;1674
3045;Benalúa de las Villas;Granada;Andalucía;1066;556;510
1020;Benalup-Casas Viejas;Cádiz;Andalucía;6929;3518;3411
2572;Benamargosa;Málaga;Andalucía;1514;788;726
2082;Benamaurel;Granada;Andalucía;2293;1157;1136
1306;Benamejí;Córdoba;Andalucía;4966;2478;2488
1768;Benamocarra;Málaga;Andalucía;3011;1509;1502
3699;Benaocaz;Cádiz;Andalucía;671;356;315
2610;Benaoján;Málaga;Andalucía;1476;765;711
4287;Benarrabá;Málaga;Andalucía;455;230;225
6133;Benasau;Alicante/Alacant;Comunidad Valenciana;151;74;77
2157;Benasque;Huesca;Aragón;2155;1151;1004
3041;Benassal;Castellón/Castelló;Comunidad Valenciana;1068;550;518
4319;Benatae;Jaén;Andalucía;448;229;219
2592;Benavent de Segrià;Lleida;Cataluña;1499;781;718
459;Benavente;Zamora;Castilla y León;17935;8683;9252
2001;Benavides;León;Castilla y León;2455;1215;1240
3826;Benavites;Valencia/València;Comunidad Valenciana;619;290;329
4946;Benegiles;Zamora;Castilla y León;305;162;143
2449;Beneixama;Alicante/Alacant;Comunidad Valenciana;1685;852;833
3743;Beneixida;Valencia/València;Comunidad Valenciana;651;323;328
1222;Benejúzar;Alicante/Alacant;Comunidad Valenciana;5402;2699;2703
549;Benetússer;Valencia/València;Comunidad Valenciana;14799;7180;7619
2291;Benferri;Alicante/Alacant;Comunidad Valenciana;1942;1001;941
2190;Beniarbeig;Alicante/Alacant;Comunidad Valenciana;2092;1061;1031
5404;Beniardá;Alicante/Alacant;Comunidad Valenciana;232;106;126
2392;Beniarjó;Valencia/València;Comunidad Valenciana;1765;892;873
2977;Beniarrés;Alicante/Alacant;Comunidad Valenciana;1118;571;547
5478;Beniatjar;Valencia/València;Comunidad Valenciana;223;116;107
291;Benicarló;Castellón/Castelló;Comunidad Valenciana;26912;13408;13504
454;Benicasim/Benicàssim;Castellón/Castelló;Comunidad Valenciana;18192;9046;9146
3955;Benicolet;Valencia/València;Comunidad Valenciana;569;283;286
3116;Benicull de Xúquer;Valencia/València;Comunidad Valenciana;1012;514;498
3005;Benidoleig;Alicante/Alacant;Comunidad Valenciana;1095;545;550
107;Benidorm;Alicante/Alacant;Comunidad Valenciana;68721;34250;34471
678;Beniel;Murcia;Región de Murcia;11318;5848;5470
652;Benifaió;Valencia/València;Comunidad Valenciana;11962;5928;6034
2533;Benifairó de la Valldigna;Valencia/València;Comunidad Valenciana;1571;780;791
2142;Benifairó de les Valls;Valencia/València;Comunidad Valenciana;2186;1085;1101
3553;Benifallet;Tarragona;Cataluña;739;348;391
6698;Benifallim;Alicante/Alacant;Comunidad Valenciana;105;60;45
6262;Benifato;Alicante/Alacant;Comunidad Valenciana;140;73;67
4277;Beniflá;Valencia/València;Comunidad Valenciana;457;236;221
1154;Benigànim;Valencia/València;Comunidad Valenciana;5841;2981;2860
4166;Benigembla;Alicante/Alacant;Comunidad Valenciana;490;253;237
1671;Benijófar;Alicante/Alacant;Comunidad Valenciana;3322;1615;1707
3586;Benilloba;Alicante/Alacant;Comunidad Valenciana;724;377;347
6828;Benillup;Alicante/Alacant;Comunidad Valenciana;97;47;50
4189;Benimantell;Alicante/Alacant;Comunidad Valenciana;483;242;241
4461;Benimarfull;Alicante/Alacant;Comunidad Valenciana;409;207;202
6673;Benimassot;Alicante/Alacant;Comunidad Valenciana;106;59;47
4424;Benimeli;Alicante/Alacant;Comunidad Valenciana;418;187;231
2099;Benimodo;Valencia/València;Comunidad Valenciana;2268;1137;1131
3741;Benimuslem;Valencia/València;Comunidad Valenciana;653;352;301
2285;Beniparrell;Valencia/València;Comunidad Valenciana;1952;982;970
2516;Benirredrà;Valencia/València;Comunidad Valenciana;1592;779;813
694;Benissa;Alicante/Alacant;Comunidad Valenciana;11005;5415;5590
2919;Benissanet;Tarragona;Cataluña;1161;646;515
2106;Benissanó;Valencia/València;Comunidad Valenciana;2260;1130;1130
4393;Benissoda;Valencia/València;Comunidad Valenciana;430;238;192
5693;Benissuera;Valencia/València;Comunidad Valenciana;194;95;99
1427;Benitachell/Poble Nou de Benitatxell, el;Alicante/Alacant;Comunidad Valenciana;4276;2106;2170
7404;Benitagla;Almería;Andalucía;58;32;26
5251;Benizalón;Almería;Andalucía;254;135;119
3086;Benlloc;Castellón/Castelló;Comunidad Valenciana;1033;518;515
7057;Benquerencia;Cáceres;Extremadura;81;47;34
3390;Benquerencia de la Serena;Badajoz;Extremadura;829;413;416
5366;Bentarique;Almería;Andalucía;238;133;105
4046;Benuza;León;Castilla y León;530;309;221
1554;Bera;Navarra;Navarra;3736;1830;1906
994;Berango;Bizkaia;País Vasco;7195;3530;3665
4291;Berantevilla;Araba/Álava;País Vasco;453;243;210
7047;Beranuy;Huesca;Aragón;82;49;33
3028;Berastegi;Gipuzkoa;País Vasco;1076;555;521
7631;Beratón;Soria;Castilla y León;47;26;21
4721;Berbegal;Huesca;Aragón;347;178;169
7502;Berberana;Burgos;Castilla y León;54;31;23
3735;Berbinzana;Navarra;Navarra;655;332;323
6061;Berceo;Rioja, La;La Rioja;157;96;61
5598;Bercero;Valladolid;Castilla y León;207;112;95
7808;Berceruelo;Valladolid;Castilla y León;36;22;14
3601;Bérchules;Granada;Andalucía;716;386;330
6606;Bercial;Segovia;Castilla y León;111;60;51
5636;Bercial de Zapardiel;Ávila;Castilla y León;200;106;94
3969;Bercianos del Páramo;León;Castilla y León;562;288;274
5695;Bercianos del Real Camino;León;Castilla y León;193;99;94
7997;Bercimuel;Segovia;Castilla y León;24;13;11
7633;Berdejo;Zaragoza;Aragón;47;32;15
498;Berga;Barcelona;Cataluña;16494;8166;8328
555;Bergara;Gipuzkoa;País Vasco;14637;7260;7377
6176;Bergasa;Rioja, La;La Rioja;148;82;66
7789;Bergasillas Bajera;Rioja, La;La Rioja;37;19;18
5387;Berge;Teruel;Aragón;235;119;116
1049;Bergondo;Coruña, A;Galicia;6633;3232;3401
1478;Beriáin;Navarra;Navarra;4069;2018;2051
628;Berja;Almería;Andalucía;12415;6293;6122
4862;Berlanas, Las;Ávila;Castilla y León;319;168;151
2056;Berlanga;Badajoz;Extremadura;2343;1165;1178
3346;Berlanga de Duero;Soria;Castilla y León;856;436;420
4663;Berlanga del Bierzo;León;Castilla y León;360;164;196
5778;Berlangas de Roa;Burgos;Castilla y León;184;100;84
6327;Bermellar;Salamanca;Castilla y León;134;68;66
491;Bermeo;Bizkaia;País Vasco;16765;8254;8511
3113;Bermillo de Sayago;Zamora;Castilla y León;1015;540;475
4224;Bernardos;Segovia;Castilla y León;476;262;214
4156;Bernedo;Araba/Álava;País Vasco;494;299;195
7599;Berninches;Guadalajara;Castilla-La Mancha;49;32;17
3534;Bernuy de Porreros;Segovia;Castilla y León;747;406;341
6748;Bernuy-Zapardiel;Ávila;Castilla y León;102;60;42
2820;Berriatua;Bizkaia;País Vasco;1245;686;559
987;Berrioplano/Berriobeiti;Navarra;Navarra;7256;3696;3560
727;Berriozar;Navarra;Navarra;10426;5251;5175
1364;Berriz;Bizkaia;País Vasco;4623;2295;2328
3863;Berrobi;Gipuzkoa;País Vasco;603;315;288
4912;Berrocal;Huelva;Andalucía;312;157;155
7229;Berrocal de Huebra;Salamanca;Castilla y León;70;39;31
7022;Berrocal de Salvatierra;Salamanca;Castilla y León;84;45;39
6784;Berrocalejo;Cáceres;Extremadura;100;55;45
7634;Berrocalejo de Aragona;Ávila;Castilla y León;46;24;22
6647;Berrueces;Valladolid;Castilla y León;109;62;47
7834;Berrueco;Zaragoza;Aragón;34;21;13
3510;Berrueco, El;Madrid;Comunidad de Madrid;760;384;376
3840;Bertizarana;Navarra;Navarra;612;302;310
4413;Berzocana;Cáceres;Extremadura;423;229;194
7916;Berzosa de Bureba;Burgos;Castilla y León;29;22;7
5608;Berzosa del Lozoya;Madrid;Comunidad de Madrid;205;115;90
7737;Berzosilla;Palencia;Castilla y León;40;21;19
1986;Besalú;Girona;Cataluña;2492;1170;1322
1310;Bescanó;Girona;Cataluña;4960;2505;2455
3516;Betancuria;Palmas, Las;Canarias;758;396;362
606;Betanzos;Coruña, A;Galicia;12959;6155;6804
4637;Betelu;Navarra;Navarra;366;191;175
328;Bétera;Valencia/València;Comunidad Valenciana;24272;12101;12171
5196;Beteta;Cuenca;Castilla-La Mancha;262;125;137
1182;Betxí;Castellón/Castelló;Comunidad Valenciana;5645;2792;2853
5716;Beuda;Girona;Cataluña;190;100;90
8021;Bezares;Rioja, La;La Rioja;22;10;12
7231;Bezas;Teruel;Aragón;70;45;25
1574;Biar;Alicante/Alacant;Comunidad Valenciana;3671;1799;1872
4035;Bicorp;Valencia/València;Comunidad Valenciana;533;262;271
4083;Bidania-Goiatz;Gipuzkoa;País Vasco;520;284;236
5978;Bidaurreta;Navarra;Navarra;163;89;74
6107;Biel;Zaragoza;Aragón;154;96;58
4273;Bielsa;Huesca;Aragón;457;242;215
3861;Bienservida;Albacete;Castilla-La Mancha;603;326;277
2192;Bienvenida;Badajoz;Extremadura;2087;1071;1016
5360;Bierge;Huesca;Aragón;239;132;107
2629;Biescas;Huesca;Aragón;1463;768;695
1038;Bigastro;Alicante/Alacant;Comunidad Valenciana;6733;3382;3351
820;Bigues i Riells;Barcelona;Cataluña;9092;4645;4447
6883;Bijuesca;Zaragoza;Aragón;94;63;31
10;Bilbao;Bizkaia;País Vasco;346843;163563;183280
2453;Bimenes;Asturias;Principado de Asturias;1681;803;878
2529;Binaced;Huesca;Aragón;1575;852;723
782;Binéfar;Huesca;Aragón;9561;5003;4558
860;Binissalem;Balears, Illes;Islas Baleares;8567;4246;4321
5859;Biosca;Lleida;Cataluña;176;94;82
3235;Biota;Zaragoza;Aragón;941;476;465
5946;Bisaurri;Huesca;Aragón;167;90;77
697;Bisbal d'Empordà, La;Girona;Cataluña;10974;5446;5528
5528;Bisbal de Falset, La;Tarragona;Cataluña;216;116;100
1612;Bisbal del Penedès, La;Tarragona;Cataluña;3528;1862;1666
5811;Biscarrués;Huesca;Aragón;182;97;85
6910;Bisimbre;Zaragoza;Aragón;92;52;40
5406;Biure;Girona;Cataluña;232;118;114
5546;Biurrun-Olcoz;Navarra;Navarra;214;120;94
7757;Blacos;Soria;Castilla y León;39;21;18
1062;Blanca;Murcia;Región de Murcia;6539;3328;3211
4535;Blancafort;Tarragona;Cataluña;389;198;191
6406;Blancas;Teruel;Aragón;126;75;51
3493;Blancos, Os;Ourense;Galicia;766;411;355
183;Blanes;Girona;Cataluña;39028;19356;19672
5694;Blascomillán;Ávila;Castilla y León;193;103;90
8082;Blasconuño de Matacabras;Ávila;Castilla y León;16;8;8
6699;Blascosancho;Ávila;Castilla y León;105;53;52
3722;Blázquez, Los;Córdoba;Andalucía;661;338;323
5812;Blecua y Torres;Huesca;Aragón;182;106;76
6881;Blesa;Teruel;Aragón;94;60;34
7853;Bliecos;Soria;Castilla y León;33;19;14
4961;Boada;Salamanca;Castilla y León;302;152;150
8076;Boada de Campos;Palencia;Castilla y León;17;13;4
5273;Boadella i les Escaules;Girona;Cataluña;252;130;122
6665;Boadilla de Rioseco;Palencia;Castilla y León;107;61;46
6458;Boadilla del Camino;Palencia;Castilla y León;121;66;55
135;Boadilla del Monte;Madrid;Comunidad de Madrid;54570;26660;27910
2581;Boal;Asturias;Principado de Asturias;1505;755;750
951;Boalo, El;Madrid;Comunidad de Madrid;7508;3757;3751
6791;Bobadilla;Rioja, La;La Rioja;100;51;49
5012;Bobadilla del Campo;Valladolid;Castilla y León;293;163;130
2086;Boborás;Ourense;Galicia;2285;1091;1194
4256;Boca de Huérgano;León;Castilla y León;464;280;184
1446;Bocairent;Valencia/València;Comunidad Valenciana;4195;2132;2063
3592;Boceguillas;Segovia;Castilla y León;723;374;349
7076;Bocigas;Valladolid;Castilla y León;80;45;35
7162;Bocos de Duero;Valladolid;Castilla y León;75;38;37
8014;Bodera, La;Guadalajara;Castilla-La Mancha;22;14;8
5148;Bodón, El;Salamanca;Castilla y León;270;147;123
3061;Bodonal de la Sierra;Badajoz;Extremadura;1049;542;507
1444;Boecillo;Valladolid;Castilla y León;4206;2143;2063
6328;Bogajo;Salamanca;Castilla y León;134;74;60
3363;Bogarra;Albacete;Castilla-La Mancha;842;443;399
6466;Bohodón, El;Ávila;Castilla y León;120;60;60
4136;Bohonal de Ibor;Cáceres;Extremadura;500;258;242
5375;Bohoyo;Ávila;Castilla y León;237;135;102
2266;Boimorto;Coruña, A;Galicia;1985;1003;982
436;Boiro;Coruña, A;Galicia;18838;9177;9661
2928;Bola, A;Ourense;Galicia;1156;545;611
653;Bolaños de Calatrava;Ciudad Real;Castilla-La Mancha;11934;6090;5844
5024;Bolaños de Campos;Valladolid;Castilla y León;291;160;131
2710;Bolbaite;Valencia/València;Comunidad Valenciana;1356;685;671
709;Bollullos de la Mitación;Sevilla;Andalucía;10787;5406;5381
562;Bollullos Par del Condado;Huelva;Andalucía;14272;7092;7180
3306;Bolo, O;Ourense;Galicia;884;448;436
3110;Boltaña;Huesca;Aragón;1016;546;470
4418;Bolulla;Alicante/Alacant;Comunidad Valenciana;420;220;200
4624;Bolvir;Girona;Cataluña;369;191;178
6961;Bonansa;Huesca;Aragón;88;50;38
1120;Bonares;Huelva;Andalucía;6058;3012;3046
3660;Bonastre;Tarragona;Cataluña;688;357;331
3060;Bonete;Albacete;Castilla-La Mancha;1049;540;509
6193;Boniches;Cuenca;Castilla-La Mancha;146;71;75
6467;Bonilla de la Sierra;Ávila;Castilla y León;120;71;49
1860;Bonillo, El;Albacete;Castilla-La Mancha;2779;1415;1364
1571;Bonrepòs i Mirambell;Valencia/València;Comunidad Valenciana;3691;1815;1876
2344;Boñar;León;Castilla y León;1832;927;905
1440;Boqueixón;Coruña, A;Galicia;4220;2091;2129
3462;Boquiñeni;Zaragoza;Aragón;787;398;389
7174;Borau;Huesca;Aragón;74;43;31
7482;Bordalba;Zaragoza;Aragón;56;36;20
5222;Bòrdes, Es;Lleida;Cataluña;259;144;115
2385;Bordils;Girona;Cataluña;1779;887;892
6794;Bordón;Teruel;Aragón;100;56;44
3256;Borge, El;Málaga;Andalucía;930;483;447
1117;Borges Blanques, Les;Lleida;Cataluña;6087;3105;2982
2224;Borges del Camp, Les;Tarragona;Cataluña;2037;1050;987
1304;Borja;Zaragoza;Aragón;4969;2534;2435
7854;Borjabad;Soria;Castilla y León;33;20;13
367;Bormujos;Sevilla;Andalucía;21972;10879;11093
936;Bornos;Cádiz;Andalucía;7670;3824;3846
5362;Borobia;Soria;Castilla y León;239;127;112
1531;Borox;Toledo;Castilla-La Mancha;3825;2002;1823
3608;Borrassà;Girona;Cataluña;714;374;340
4331;Borredà;Barcelona;Cataluña;445;253;192
4891;Borrenes;León;Castilla y León;315;168;147
212;Borriana/Burriana;Castellón/Castelló;Comunidad Valenciana;34683;17224;17459
1230;Borriol;Castellón/Castelló;Comunidad Valenciana;5360;2736;2624
2160;Bosque, El;Cádiz;Andalucía;2145;1083;1062
2988;Bossòst;Lleida;Cataluña;1109;542;567
3944;Bot;Tarragona;Cataluña;573;295;278
3042;Botarell;Tarragona;Cataluña;1068;549;519
5871;Botija;Cáceres;Extremadura;175;93;82
4180;Botorrita;Zaragoza;Aragón;488;269;219
7493;Bouza, La;Salamanca;Castilla y León;55;24;31
2603;Bóveda;Lugo;Galicia;1481;768;713
3622;Bóveda de Toro, La;Zamora;Castilla y León;709;357;352
5429;Bóveda del Río Almar;Salamanca;Castilla y León;229;125;104
5316;Bovera;Lleida;Cataluña;247;133;114
6857;Bozoó;Burgos;Castilla y León;95;58;37
7635;Brabos;Ávila;Castilla y León;46;29;17
3651;Bràfim;Tarragona;Cataluña;692;357;335
6514;Brahojos de Medina;Valladolid;Castilla y León;117;61;56
5140;Brañosera;Palencia;Castilla y León;271;147;124
5609;Braojos;Madrid;Comunidad de Madrid;205;121;84
7458;Brazacorta;Burgos;Castilla y León;56;32;24
3122;Brazatortas;Ciudad Real;Castilla-La Mancha;1005;523;482
4999;Brazuelo;León;Castilla y León;295;161;134
2505;Brea de Aragón;Zaragoza;Aragón;1609;823;786
4069;Brea de Tajo;Madrid;Comunidad de Madrid;524;301;223
1552;Breda;Girona;Cataluña;3740;1836;1904
624;Brenes;Sevilla;Andalucía;12471;6181;6290
992;Breña Alta;Santa Cruz de Tenerife;Canarias;7204;3540;3664
1173;Breña Baja;Santa Cruz de Tenerife;Canarias;5690;2857;2833
5956;Bretó;Zamora;Castilla y León;166;97;69
5556;Bretocino;Zamora;Castilla y León;213;115;98
6846;Brieva;Segovia;Castilla y León;96;52;44
7675;Brieva de Cameros;Rioja, La;La Rioja;44;29;15
2026;Brihuega;Guadalajara;Castilla-La Mancha;2410;1247;1163
6363;Brime de Sog;Zamora;Castilla y León;130;62;68
6727;Brime de Urz;Zamora;Castilla y León;104;62;42
7419;Brincones;Salamanca;Castilla y León;58;29;29
5697;Briñas;Rioja, La;La Rioja;193;90;103
922;Brión;Coruña, A;Galicia;7837;3773;4064
3538;Briones;Rioja, La;La Rioja;745;392;353
1052;Briviesca;Burgos;Castilla y León;6595;3290;3305
4385;Bronchales;Teruel;Aragón;432;248;184
4075;Broto;Huesca;Aragón;522;292;230
2351;Brozas;Cáceres;Extremadura;1826;912;914
2217;Bruc, El;Barcelona;Cataluña;2050;1107;943
5185;Brull, El;Barcelona;Cataluña;263;145;118
711;Brunete;Madrid;Comunidad de Madrid;10736;5283;5453
4556;Brunyola i Sant Martí Sapresa;Girona;Cataluña;383;195;188
7891;Buberos;Soria;Castilla y León;31;17;14
7291;Bubierca;Zaragoza;Aragón;66;34;32
4992;Bubión;Granada;Andalucía;296;150;146
7797;Buciegas;Cuenca;Castilla-La Mancha;36;25;11
5674;Budia;Guadalajara;Castilla-La Mancha;196;116;80
4271;Buenache de Alarcón;Cuenca;Castilla-La Mancha;459;239;220
6832;Buenache de la Sierra;Cuenca;Castilla-La Mancha;97;56;41
6389;Buenamadre;Salamanca;Castilla y León;127;66;61
4409;Buenaventura;Toledo;Castilla-La Mancha;424;216;208
4664;Buenavista;Salamanca;Castilla y León;360;198;162
5325;Buenavista de Valdavia;Palencia;Castilla y León;245;139;106
1335;Buenavista del Norte;Santa Cruz de Tenerife;Canarias;4778;2405;2373
4501;Buendía;Cuenca;Castilla-La Mancha;400;213;187
7588;Bueña;Teruel;Aragón;50;27;23
648;Bueu;Pontevedra;Galicia;12009;5924;6085
6014;Bufali;Valencia/València;Comunidad Valenciana;161;86;75
3580;Bugarra;Valencia/València;Comunidad Valenciana;727;374;353
5754;Bugedo;Burgos;Castilla y León;186;120;66
3058;Búger;Balears, Illes;Islas Baleares;1050;551;499
7306;Buitrago;Soria;Castilla y León;65;34;31
2311;Buitrago del Lozoya;Madrid;Comunidad de Madrid;1884;898;986
967;Bujalance;Córdoba;Andalucía;7417;3691;3726
7625;Bujalaro;Guadalajara;Castilla-La Mancha;47;22;25
3156;Bujaraloz;Zaragoza;Aragón;985;504;481
7277;Bularros;Ávila;Castilla y León;66;43;23
5493;Bulbuente;Zaragoza;Aragón;221;120;101
667;Bullas;Murcia;Región de Murcia;11530;5795;5735
4000;Buniel;Burgos;Castilla y León;546;300;246
1028;Bunyola;Balears, Illes;Islas Baleares;6809;3333;3476
793;Buñol;Valencia/València;Comunidad Valenciana;9408;4693;4715
2131;Buñuel;Navarra;Navarra;2219;1081;1138
5300;Burbáguena;Teruel;Aragón;249;131;118
780;Burela;Lugo;Galicia;9588;4754;4834
5552;Bureta;Zaragoza;Aragón;214;109;105
3717;Burganes de Valverde;Zamora;Castilla y León;663;348;315
2007;Burgo de Ebro, El;Zaragoza;Aragón;2436;1233;1203
1312;Burgo de Osma-Ciudad de Osma;Soria;Castilla y León;4940;2463;2477
3605;Burgo Ranero, El;León;Castilla y León;715;377;338
2374;Burgo, El;Málaga;Andalucía;1800;929;871
2870;Burgohondo;Ávila;Castilla y León;1195;622;573
36;Burgos;Burgos;Castilla y León;175821;83713;92108
5595;Burgui/Burgi;Navarra;Navarra;207;119;88
1039;Burguillos;Sevilla;Andalucía;6716;3388;3328
1714;Burguillos de Toledo;Toledo;Castilla-La Mancha;3172;1636;1536
1747;Burguillos del Cerro;Badajoz;Extremadura;3057;1508;1549
189;Burjassot;Valencia/València;Comunidad Valenciana;38024;18332;19692
432;Burlada/Burlata;Navarra;Navarra;19096;9223;9873
4932;Burón;León;Castilla y León;308;176;132
2743;Burujón;Toledo;Castilla-La Mancha;1319;670;649
1783;Busot;Alicante/Alacant;Comunidad Valenciana;2978;1516;1462
5032;Busquístar;Granada;Andalucía;289;149;140
7083;Bustares;Guadalajara;Castilla-La Mancha;79;49;30
1980;Bustarviejo;Madrid;Comunidad de Madrid;2503;1256;1247
7292;Buste, El;Zaragoza;Aragón;66;36;30
7244;Bustillo de Chaves;Valladolid;Castilla y León;69;43;26
5011;Bustillo de la Vega;Palencia;Castilla y León;293;159;134
7027;Bustillo del Oro;Zamora;Castilla y León;84;44;40
2911;Bustillo del Páramo;León;Castilla y León;1165;599;566
7382;Bustillo del Páramo de Carrión;Palencia;Castilla y León;60;37;23
6277;Busto de Bureba;Burgos;Castilla y León;139;74;65
7467;Busto, El;Navarra;Navarra;56;27;29
2495;Busturia;Bizkaia;País Vasco;1616;807;809
4981;Cabacés;Tarragona;Cataluña;298;155;143
5490;Cabaco, El;Salamanca;Castilla y León;221;114;107
7035;Caballar;Segovia;Castilla y León;83;48;35
1434;Cabana de Bergantiños;Coruña, A;Galicia;4248;2054;2194
7152;Cabanabona;Lleida;Cataluña;75;36;39
1688;Cabanas;Coruña, A;Galicia;3281;1606;1675
5095;Cabanelles;Girona;Cataluña;279;154;125
1793;Cabanes;Castellón/Castelló;Comunidad Valenciana;2958;1509;1449
3224;Cabanes;Girona;Cataluña;948;500;448
2707;Cabanillas;Navarra;Navarra;1357;717;640
3521;Cabanillas de la Sierra;Madrid;Comunidad de Madrid;756;392;364
726;Cabanillas del Campo;Guadalajara;Castilla-La Mancha;10442;5274;5168
3190;Cabanyes, Les;Barcelona;Cataluña;964;488;476
4129;Cabañas de Ebro;Zaragoza;Aragón;505;269;236
2375;Cabañas de la Sagra;Toledo;Castilla-La Mancha;1799;922;877
5852;Cabañas de Polendos;Segovia;Castilla y León;177;94;83
6146;Cabañas de Sayago;Zamora;Castilla y León;151;80;71
5237;Cabañas de Yepes;Toledo;Castilla-La Mancha;257;135;122
4388;Cabañas del Castillo;Cáceres;Extremadura;431;225;206
2709;Cabañas Raras;León;Castilla y León;1356;698;658
5966;Cabañes de Esgueva;Burgos;Castilla y León;164;94;70
7346;Cabeza de Béjar, La;Salamanca;Castilla y León;62;38;24
1321;Cabeza del Buey;Badajoz;Extremadura;4864;2407;2457
5098;Cabeza del Caballo;Salamanca;Castilla y León;279;149;130
2751;Cabeza la Vaca;Badajoz;Extremadura;1309;669;640
4734;Cabezabellosa;Cáceres;Extremadura;344;174;170
7121;Cabezabellosa de la Calzada;Salamanca;Castilla y León;77;46;31
4730;Cabezamesada;Toledo;Castilla-La Mancha;346;189;157
4849;Cabezarados;Ciudad Real;Castilla-La Mancha;322;173;149
4198;Cabezarrubias del Puerto;Ciudad Real;Castilla-La Mancha;481;252;229
6053;Cabezas de Alambre;Ávila;Castilla y León;157;78;79
500;Cabezas de San Juan, Las;Sevilla;Andalucía;16417;8217;8200
7143;Cabezas del Pozo;Ávila;Castilla y León;75;41;34
5212;Cabezas del Villar;Ávila;Castilla y León;260;142;118
3576;Cabezas Rubias;Huelva;Andalucía;730;383;347
8069;Cabezón de Cameros;Rioja, La;La Rioja;18;12;6
884;Cabezón de la Sal;Cantabria;Cantabria;8301;3983;4318
7728;Cabezón de la Sierra;Burgos;Castilla y León;40;17;23
3834;Cabezón de Liébana;Cantabria;Cantabria;616;350;266
1565;Cabezón de Pisuerga;Valladolid;Castilla y León;3713;1893;1820
7857;Cabezón de Valderaduey;Valladolid;Castilla y León;33;19;14
3715;Cabezuela;Segovia;Castilla y León;664;343;321
2138;Cabezuela del Valle;Cáceres;Extremadura;2194;1121;1073
7011;Cabizuela;Ávila;Castilla y León;84;43;41
6902;Cabó;Lleida;Cataluña;92;49;43
7861;Cabolafuente;Zaragoza;Aragón;33;19;14
401;Cabra;Córdoba;Andalucía;20341;9905;10436
7512;Cabra de Mora;Teruel;Aragón;54;34;20
2917;Cabra del Camp;Tarragona;Cataluña;1163;608;555
2386;Cabra del Santo Cristo;Jaén;Andalucía;1779;930;849
2279;Cabrales;Asturias;Principado de Asturias;1960;1001;959
3083;Cabranes;Asturias;Principado de Asturias;1034;519;515
6920;Cabredo;Navarra;Navarra;91;49;42
7529;Cabrejas del Campo;Soria;Castilla y León;53;34;19
4725;Cabrejas del Pinar;Soria;Castilla y León;347;198;149
2662;Cabrera d'Anoia;Barcelona;Cataluña;1410;769;641
1350;Cabrera de Mar;Barcelona;Cataluña;4680;2348;2332
1906;Cabrera, La;Madrid;Comunidad de Madrid;2667;1313;1354
1430;Cabrerizos;Salamanca;Castilla y León;4263;2121;2142
4828;Cabrero;Cáceres;Extremadura;326;179;147
7350;Cabreros del Monte;Valladolid;Castilla y León;62;36;26
4444;Cabreros del Río;León;Castilla y León;413;223;190
3515;Cabrillanes;León;Castilla y León;759;395;364
4622;Cabrillas;Salamanca;Castilla y León;370;188;182
963;Cabrils;Barcelona;Cataluña;7439;3682;3757
3132;Cabuérniga;Cantabria;Cantabria;1000;537;463
1283;Cacabelos;León;Castilla y León;5118;2543;2575
67;Cáceres;Cáceres;Extremadura;96126;46067;50059
7044;Cachorrilla;Cáceres;Extremadura;82;40;42
3954;Cacín;Granada;Andalucía;569;289;280
4389;Cadalso;Cáceres;Extremadura;431;218;213
1758;Cadalso de los Vidrios;Madrid;Comunidad de Madrid;3039;1593;1446
1884;Cadaqués;Girona;Cataluña;2712;1322;1390
2635;Cádiar;Granada;Andalucía;1453;766;687
57;Cádiz;Cádiz;Andalucía;116027;54918;61109
2277;Cadreita;Navarra;Navarra;1964;1008;956
1487;Cadrete;Zaragoza;Aragón;4032;2137;1895
1279;Cájar;Granada;Andalucía;5129;2468;2661
2910;Cala;Huelva;Andalucía;1167;587;580
7944;Calabazas de Fuentidueña;Segovia;Castilla y León;28;15;13
3144;Calaceite;Teruel;Aragón;994;488;506
1608;Calaf;Barcelona;Cataluña;3535;1775;1760
295;Calafell;Tarragona;Cataluña;26538;13362;13176
330;Calahorra;Rioja, La;La Rioja;24220;11900;12320
6932;Calahorra de Boedo;Palencia;Castilla y León;90;44;46
3693;Calahorra, La;Granada;Andalucía;673;343;330
1415;Calamocha;Teruel;Aragón;4339;2166;2173
1110;Calamonte;Badajoz;Extremadura;6162;3058;3104
1550;Calanda;Teruel;Aragón;3748;1852;1896
1858;Calañas;Huelva;Andalucía;2791;1422;1369
745;Calasparra;Murcia;Región de Murcia;10178;5147;5031
7567;Calatañazor;Soria;Castilla y León;51;29;22
413;Calatayud;Zaragoza;Aragón;20024;9902;10122
1822;Calatorao;Zaragoza;Aragón;2881;1493;1388
7207;Calcena;Zaragoza;Aragón;72;42;30
768;Caldas de Reis;Pontevedra;Galicia;9785;4706;5079
5426;Caldearenas;Huesca;Aragón;229;136;93
3179;Calders;Barcelona;Cataluña;970;499;471
1782;Caldes d'Estrac;Barcelona;Cataluña;2982;1426;1556
937;Caldes de Malavella;Girona;Cataluña;7641;3828;3813
470;Caldes de Montbui;Barcelona;Cataluña;17554;8745;8809
434;Calella;Barcelona;Cataluña;19069;9339;9730
3200;Calera de León;Badajoz;Extremadura;960;486;474
1358;Calera y Chozas;Toledo;Castilla-La Mancha;4646;2341;2305
4411;Caleruega;Burgos;Castilla y León;423;215;208
5592;Caleruela;Toledo;Castilla-La Mancha;208;100;108
3829;Calicasas;Granada;Andalucía;617;306;311
2287;Càlig;Castellón/Castelló;Comunidad Valenciana;1950;989;961
1989;Calldetenes;Barcelona;Cataluña;2489;1259;1230
4683;Calles;Valencia/València;Comunidad Valenciana;355;204;151
972;Callosa d'en Sarrià;Alicante/Alacant;Comunidad Valenciana;7373;3762;3611
435;Callosa de Segura;Alicante/Alacant;Comunidad Valenciana;19038;9714;9324
2164;Callús;Barcelona;Cataluña;2140;1061;1079
7454;Calmarza;Zaragoza;Aragón;57;31;26
7160;Calomarde;Teruel;Aragón;75;44;31
5733;Calonge de Segarra;Barcelona;Cataluña;188;92;96
687;Calonge i Sant Antoni;Girona;Cataluña;11092;5571;5521
350;Calp;Alicante/Alacant;Comunidad Valenciana;22725;11480;11245
7544;Caltojar;Soria;Castilla y León;52;36;16
2916;Calvarrasa de Abajo;Salamanca;Castilla y León;1163;617;546
3910;Calvarrasa de Arriba;Salamanca;Castilla y León;586;315;271
147;Calvià;Balears, Illes;Islas Baleares;50559;25395;25164
3489;Calvos de Randín;Ourense;Galicia;770;383;387
6996;Calzada de Béjar, La;Salamanca;Castilla y León;86;46;40
1559;Calzada de Calatrava;Ciudad Real;Castilla-La Mancha;3719;1849;1870
6127;Calzada de Don Diego;Salamanca;Castilla y León;152;82;70
4806;Calzada de los Molinos;Palencia;Castilla y León;330;183;147
4052;Calzada de Oropesa;Toledo;Castilla-La Mancha;529;291;238
3630;Calzada de Valdunciel;Salamanca;Castilla y León;703;349;354
5475;Calzada del Coto;León;Castilla y León;223;133;90
4227;Calzadilla;Cáceres;Extremadura;475;243;232
3523;Calzadilla de los Barros;Badajoz;Extremadura;755;375;380
4972;Calzadilla de Tera;Zamora;Castilla y León;300;144;156
3240;Camaleño;Cantabria;Cantabria;936;534;402
6329;Camañas;Teruel;Aragón;134;78;56
3411;Camarasa;Lleida;Cataluña;817;410;407
1499;Camarena;Toledo;Castilla-La Mancha;3960;2058;1902
6711;Camarena de la Sierra;Teruel;Aragón;105;65;40
3964;Camarenilla;Toledo;Castilla-La Mancha;565;283;282
253;Camargo;Cantabria;Cantabria;30260;14806;15454
6795;Camarillas;Teruel;Aragón;100;61;39
1248;Camariñas;Coruña, A;Galicia;5272;2577;2695
1704;Camarles;Tarragona;Cataluña;3224;1638;1586
978;Camarma de Esteruelas;Madrid;Comunidad de Madrid;7336;3726;3610
3481;Camarzana de Tera;Zamora;Castilla y León;776;386;390
283;Camas;Sevilla;Andalucía;27509;13425;14084
577;Cambados;Pontevedra;Galicia;13744;6614;7130
1890;Cambil;Jaén;Andalucía;2703;1411;1292
320;Cambre;Coruña, A;Galicia;24648;12024;12624
219;Cambrils;Tarragona;Cataluña;33898;16553;17345
2872;Caminomorisco;Cáceres;Extremadura;1194;623;571
3820;Caminreal;Teruel;Aragón;620;324;296
3647;Camós;Girona;Cataluña;693;341;352
1246;Campana, La;Sevilla;Andalucía;5276;2643;2633
1316;Campanario;Badajoz;Extremadura;4896;2403;2493
1915;Campanet;Balears, Illes;Islas Baleares;2640;1352;1288
3023;Campaspero;Valladolid;Castilla y León;1079;600;479
6479;Campazas;León;Castilla y León;119;55;64
1705;Campdevànol;Girona;Cataluña;3223;1566;1657
6280;Campelles;Girona;Cataluña;139;71;68
271;Campello, el;Alicante/Alacant;Comunidad Valenciana;28349;13796;14553
3072;Campezo/Kanpezu;Araba/Álava;País Vasco;1040;546;494
2741;Campillo de Altobuey;Cuenca;Castilla-La Mancha;1322;655;667
6191;Campillo de Aragón;Zaragoza;Aragón;147;82;65
5808;Campillo de Aranda;Burgos;Castilla y León;182;110;72
2400;Campillo de Arenas;Jaén;Andalucía;1760;896;864
6036;Campillo de Azaba;Salamanca;Castilla y León;159;94;65
7082;Campillo de Deleitosa;Cáceres;Extremadura;79;35;44
7101;Campillo de Dueñas;Guadalajara;Castilla-La Mancha;78;45;33
4738;Campillo de la Jara, El;Toledo;Castilla-La Mancha;344;180;164
2703;Campillo de Llerena;Badajoz;Extremadura;1360;689;671
5907;Campillo de Ranas;Guadalajara;Castilla-La Mancha;171;105;66
2238;Campillo, El;Huelva;Andalucía;2023;980;1043
5484;Campillo, El;Valladolid;Castilla y León;222;133;89
872;Campillos;Málaga;Andalucía;8444;4270;4174
6704;Campillos-Paravientos;Cuenca;Castilla-La Mancha;105;60;45
7763;Campillos-Sierra;Cuenca;Castilla-La Mancha;38;17;21
4050;Campins;Barcelona;Cataluña;529;277;252
7438;Campisábalos;Guadalajara;Castilla-La Mancha;57;44;13
3999;Campllong;Girona;Cataluña;547;272;275
5101;Campo;Huesca;Aragón;278;149;129
589;Campo de Criptana;Ciudad Real;Castilla-La Mancha;13414;6684;6730
4435;Campo de Mirra/Camp de Mirra, el;Alicante/Alacant;Comunidad Valenciana;415;211;204
5207;Campo de Peñaranda, El;Salamanca;Castilla y León;261;153;108
5370;Campo de San Pedro;Segovia;Castilla y León;238;129;109
5584;Campo de Villavidel;León;Castilla y León;209;114;95
2361;Campo Lameiro;Pontevedra;Galicia;1817;858;959
3383;Campo Lugar;Cáceres;Extremadura;833;415;418
1104;Campo Real;Madrid;Comunidad de Madrid;6210;3138;3072
3689;Campofrío;Huelva;Andalucía;675;343;332
7431;Campolara;Burgos;Castilla y León;57;41;16
1476;Camponaraya;León;Castilla y León;4096;2022;2074
1563;Campoo de Enmedio;Cantabria;Cantabria;3714;1902;1812
3702;Campoo de Yuso;Cantabria;Cantabria;669;364;305
6067;Camporredondo;Valladolid;Castilla y León;157;89;68
6324;Camporrélls;Huesca;Aragón;134;71;63
2878;Camporrobles;Valencia/València;Comunidad Valenciana;1191;611;580
703;Campos;Balears, Illes;Islas Baleares;10862;5433;5429
3555;Campos del Paraíso;Cuenca;Castilla-La Mancha;737;374;363
2234;Campos del Río;Murcia;Región de Murcia;2028;956;1072
2830;Campotéjar;Granada;Andalucía;1237;631;606
2088;Camprodon;Girona;Cataluña;2281;1117;1164
6141;Camprovín;Rioja, La;La Rioja;151;82;69
2425;Camuñas;Toledo;Castilla-La Mancha;1726;887;839
4895;Canal de Berdún;Huesca;Aragón;314;176;138
5416;Canalejas de Peñafiel;Valladolid;Castilla y León;231;128;103
5759;Canalejas del Arroyo;Cuenca;Castilla-La Mancha;186;102;84
7650;Canales;Ávila;Castilla y León;45;25;20
6924;Canales de la Sierra;Rioja, La;La Rioja;91;57;34
582;Canals;Valencia/València;Comunidad Valenciana;13587;6807;6780
2288;Candamo;Asturias;Principado de Asturias;1947;950;997
4262;Candasnos;Huesca;Aragón;462;255;207
276;Candelaria;Santa Cruz de Tenerife;Canarias;27985;13619;14366
3311;Candelario;Salamanca;Castilla y León;879;447;432
1298;Candeleda;Ávila;Castilla y León;5018;2536;2482
6567;Candilichera;Soria;Castilla y León;113;66;47
5123;Candín;León;Castilla y León;274;151;123
6663;Canejan;Lleida;Cataluña;107;57;50
2346;Canena;Jaén;Andalucía;1831;935;896
4322;Canencia;Madrid;Comunidad de Madrid;447;245;202
3590;Canet d'Adri;Girona;Cataluña;723;371;352
1041;Canet d'En Berenguer;Valencia/València;Comunidad Valenciana;6697;3426;3271
557;Canet de Mar;Barcelona;Cataluña;14526;7068;7458
3692;Canet lo Roig;Castellón/Castelló;Comunidad Valenciana;674;330;344
4016;Canfranc;Huesca;Aragón;540;300;240
294;Cangas;Pontevedra;Galicia;26542;13135;13407
1109;Cangas de Onís;Asturias;Principado de Asturias;6163;2997;3166
631;Cangas del Narcea;Asturias;Principado de Asturias;12347;6070;6277
4308;Canicosa de la Sierra;Burgos;Castilla y León;449;237;212
1484;Caniles;Granada;Andalucía;4047;2076;1971
6997;Canillas de Abajo;Salamanca;Castilla y León;86;59;27
2461;Canillas de Aceituno;Málaga;Andalucía;1677;890;787
3602;Canillas de Albaida;Málaga;Andalucía;716;355;361
7163;Canillas de Esgueva;Valladolid;Castilla y León;75;44;31
7739;Canillas de Río Tuerto;Rioja, La;La Rioja;40;22;18
2852;Canjáyar;Almería;Andalucía;1214;641;573
1143;Canonja, La;Tarragona;Cataluña;5893;2892;3001
493;Canovelles;Barcelona;Cataluña;16629;8613;8016
1727;Cànoves i Samalús;Barcelona;Cataluña;3117;1581;1536
7263;Canredondo;Guadalajara;Castilla-La Mancha;67;44;23
7975;Cantabrana;Burgos;Castilla y León;25;15;10
5250;Cantagallo;Salamanca;Castilla y León;255;135;120
3214;Cantalapiedra;Salamanca;Castilla y León;953;499;454
1613;Cantalejo;Segovia;Castilla y León;3523;1757;1766
4901;Cantallops;Girona;Cataluña;313;153;160
6137;Cantalojas;Guadalajara;Castilla-La Mancha;151;90;61
3357;Cantalpino;Salamanca;Castilla y León;851;463;388
5720;Cantaracillo;Salamanca;Castilla y León;190;104;86
3619;Cantavieja;Teruel;Aragón;709;368;341
715;Cantillana;Sevilla;Andalucía;10684;5454;5230
2737;Cantimpalos;Segovia;Castilla y León;1325;694;631
6730;Cantiveros;Ávila;Castilla y León;103;59;44
1710;Cantoria;Almería;Andalucía;3204;1625;1579
1356;Canyelles;Barcelona;Cataluña;4647;2414;2233
2850;Cañada;Alicante/Alacant;Comunidad Valenciana;1220;606;614
7807;Cañada de Benatanduz;Teruel;Aragón;36;24;12
6755;Cañada de Calatrava;Ciudad Real;Castilla-La Mancha;102;60;42
6955;Cañada de Verich, La;Teruel;Aragón;89;55;34
5331;Cañada del Hoyo;Cuenca;Castilla-La Mancha;243;125;118
5350;Cañada Juncosa;Cuenca;Castilla-La Mancha;240;130;110
1673;Cañada Rosal;Sevilla;Andalucía;3320;1641;1679
7894;Cañada Vellida;Teruel;Aragón;31;22;9
7912;Cañamaque;Soria;Castilla y León;30;19;11
4249;Cañamares;Cuenca;Castilla-La Mancha;466;254;212
2500;Cañamero;Cáceres;Extremadura;1614;838;776
4704;Cáñar;Granada;Andalucía;350;190;160
6763;Cañas;Rioja, La;La Rioja;102;53;49
6194;Cañavate, El;Cuenca;Castilla-La Mancha;146;73;73
3087;Cañaveral;Cáceres;Extremadura;1031;510;521
4490;Cañaveral de León;Huelva;Andalucía;403;205;198
5226;Cañaveras;Cuenca;Castilla-La Mancha;258;127;131
6343;Cañaveruelas;Cuenca;Castilla-La Mancha;132;67;65
3552;Cañete;Cuenca;Castilla-La Mancha;739;377;362
1803;Cañete de las Torres;Córdoba;Andalucía;2933;1512;1421
2467;Cañete la Real;Málaga;Andalucía;1665;846;819
1265;Cañiza, A;Pontevedra;Galicia;5180;2535;2645
4283;Cañizal;Zamora;Castilla y León;456;236;220
7508;Cañizar;Guadalajara;Castilla-La Mancha;54;31;23
6796;Cañizar del Olivar;Teruel;Aragón;100;53;47
4350;Cañizares;Cuenca;Castilla-La Mancha;439;240;199
5403;Cañizo;Zamora;Castilla y León;233;129;104
6462;Capafonts;Tarragona;Cataluña;121;62;59
1869;Caparroso;Navarra;Navarra;2766;1458;1308
4506;Capçanes;Tarragona;Cataluña;398;202;196
654;Capdepera;Balears, Illes;Islas Baleares;11868;6059;5809
5657;Capdesaso;Huesca;Aragón;198;83;115
2837;Capela, A;Coruña, A;Galicia;1232;612;620
4710;Capella;Huesca;Aragón;349;182;167
1245;Capellades;Barcelona;Cataluña;5293;2636;2657
3989;Capileira;Granada;Andalucía;554;277;277
5806;Capilla;Badajoz;Extremadura;182;96;86
7155;Capillas;Palencia;Castilla y León;75;40;35
3838;Capmany;Girona;Cataluña;613;307;306
6869;Capolat;Barcelona;Cataluña;94;44;50
8094;Carabantes;Soria;Castilla y León;15;8;7
2252;Carabaña;Madrid;Comunidad de Madrid;2010;1002;1008
7446;Carabias;Segovia;Castilla y León;57;38;19
8080;Caracena;Soria;Castilla y León;17;11;6
6322;Caracuel de Calatrava;Ciudad Real;Castilla-La Mancha;134;77;57
5686;Carataunas;Granada;Andalucía;194;102;92
305;Caravaca de la Cruz;Murcia;Región de Murcia;25760;12903;12857
4219;Caravia;Asturias;Principado de Asturias;477;246;231
7839;Carazo;Burgos;Castilla y León;33;23;10
4066;Carbajales de Alba;Zamora;Castilla y León;525;266;259
5638;Carbajo;Cáceres;Extremadura;200;104;96
999;Carbajosa de la Sagrada;Salamanca;Castilla y León;7116;3541;3575
2770;Carballeda de Avia;Ourense;Galicia;1286;627;659
2551;Carballeda de Valdeorras;Ourense;Galicia;1545;793;752
2140;Carballedo;Lugo;Galicia;2193;1102;1091
569;Carballiño, O;Ourense;Galicia;14027;6505;7522
240;Carballo;Coruña, A;Galicia;31349;15342;16007
5731;Carbellino;Zamora;Castilla y León;189;102;87
900;Carboneras;Almería;Andalucía;8004;4120;3884
3425;Carboneras de Guadazaón;Cuenca;Castilla-La Mancha;811;417;394
1974;Carbonero el Mayor;Segovia;Castilla y León;2519;1305;1214
3836;Carboneros;Jaén;Andalucía;615;318;297
2998;Carcaboso;Cáceres;Extremadura;1100;547;553
2022;Carcabuey;Córdoba;Andalucía;2412;1226;1186
398;Carcaixent;Valencia/València;Comunidad Valenciana;20358;10071;10287
3038;Cárcar;Navarra;Navarra;1069;541;528
1984;Carcastillo;Navarra;Navarra;2495;1269;1226
7702;Carcedo de Bureba;Burgos;Castilla y León;42;23;19
4503;Carcedo de Burgos;Burgos;Castilla y León;399;212;187
4133;Carcelén;Albacete;Castilla-La Mancha;501;271;230
2321;Càrcer;Valencia/València;Comunidad Valenciana;1862;885;977
2701;Cárcheles;Jaén;Andalucía;1363;716;647
451;Cardedeu;Barcelona;Cataluña;18357;8957;9400
6304;Cárdenas;Rioja, La;La Rioja;136;72;64
4148;Cardenete;Cuenca;Castilla-La Mancha;496;267;229
2598;Cardeña;Córdoba;Andalucía;1490;740;750
2728;Cardeñadijo;Burgos;Castilla y León;1341;735;606
2993;Cardeñajimeno;Burgos;Castilla y León;1105;570;535
4321;Cardeñosa;Ávila;Castilla y León;447;240;207
7579;Cardeñosa de Volpejera;Palencia;Castilla y León;50;26;24
6531;Cardeñuela Riopico;Burgos;Castilla y León;115;67;48
4682;Cardiel de los Montes;Toledo;Castilla-La Mancha;355;194;161
1362;Cardona;Barcelona;Cataluña;4636;2273;2363
7380;Cardoso de la Sierra, El;Guadalajara;Castilla-La Mancha;60;37;23
5557;Carenas;Zaragoza;Aragón;213;116;97
1680;Cariñena;Zaragoza;Aragón;3302;1676;1626
1528;Cariño;Coruña, A;Galicia;3838;1901;1937
521;Carlet;Valencia/València;Comunidad Valenciana;15598;7769;7829
568;Carlota, La;Córdoba;Andalucía;14061;7033;7028
3495;Carme;Barcelona;Cataluña;765;396;369
3545;Carmena;Toledo;Castilla-La Mancha;743;376;367
4691;Cármenes;León;Castilla y León;352;196;156
270;Carmona;Sevilla;Andalucía;28531;14349;14182
4014;Carmonita;Badajoz;Extremadura;540;274;266
1500;Carnota;Coruña, A;Galicia;3957;1871;2086
533;Carolina, La;Jaén;Andalucía;15261;7546;7715
3112;Carpio;Valladolid;Castilla y León;1016;545;471
6587;Carpio de Azaba;Salamanca;Castilla y León;112;63;49
2339;Carpio de Tajo, El;Toledo;Castilla-La Mancha;1838;920;918
1412;Carpio, El;Córdoba;Andalucía;4383;2166;2217
1638;Carracedelo;León;Castilla y León;3425;1713;1712
1076;Carral;Coruña, A;Galicia;6408;3151;3257
1327;Carranque;Toledo;Castilla-La Mancha;4846;2526;2320
2859;Carrascal de Barregas;Salamanca;Castilla y León;1206;630;576
5585;Carrascal del Obispo;Salamanca;Castilla y León;209;113;96
6185;Carrascal del Río;Segovia;Castilla y León;147;79;68
5524;Carrascalejo;Cáceres;Extremadura;216;108;108
7029;Carrascalejo, El;Badajoz;Extremadura;83;42;41
7221;Carrascosa;Cuenca;Castilla-La Mancha;70;42;28
8040;Carrascosa de Abajo;Soria;Castilla y León;21;14;7
6678;Carrascosa de Haro;Cuenca;Castilla-La Mancha;106;56;50
8057;Carrascosa de la Sierra;Soria;Castilla y León;19;14;5
3574;Carratraca;Málaga;Andalucía;731;383;348
735;Carreño;Asturias;Principado de Asturias;10337;4977;5360
5868;Carrera, La;Ávila;Castilla y León;175;96;79
7966;Carrias;Burgos;Castilla y León;26;20;6
5200;Carriches;Toledo;Castilla-La Mancha;262;131;131
6882;Carrícola;Valencia/València;Comunidad Valenciana;94;47;47
1737;Carrión de Calatrava;Ciudad Real;Castilla-La Mancha;3082;1542;1540
1958;Carrión de los Céspedes;Sevilla;Andalucía;2544;1248;1296
2202;Carrión de los Condes;Palencia;Castilla y León;2069;985;1084
2122;Carrizo;León;Castilla y León;2228;1130;1098
2854;Carrizosa;Ciudad Real;Castilla-La Mancha;1212;619;593
4301;Carrocera;León;Castilla y León;451;249;202
24;Cartagena;Murcia;Región de Murcia;214802;106951;107851
5266;Cartajima;Málaga;Andalucía;253;136;117
299;Cártama;Málaga;Andalucía;26259;13266;12993
414;Cartaya;Huelva;Andalucía;19974;10228;9746
1914;Cartelle;Ourense;Galicia;2642;1298;1344
1163;Cartes;Cantabria;Cantabria;5747;2884;2863
3970;Carucedo;León;Castilla y León;562;284;278
6947;Casa de Uceda;Guadalajara;Castilla-La Mancha;89;48;41
1614;Casabermeja;Málaga;Andalucía;3522;1844;1678
7305;Casafranca;Salamanca;Castilla y León;65;35;30
3001;Casalarreina;Rioja, La;La Rioja;1098;556;542
1394;Casar de Cáceres;Cáceres;Extremadura;4469;2187;2282
2430;Casar de Escalona, El;Toledo;Castilla-La Mancha;1725;931;794
2955;Casar de Palomero;Cáceres;Extremadura;1133;578;555
644;Casar, El;Guadalajara;Castilla-La Mancha;12062;6120;5942
1981;Casarabonela;Málaga;Andalucía;2502;1336;1166
5927;Casarejos;Soria;Castilla y León;169;88;81
1066;Casares;Málaga;Andalucía;6515;3355;3160
4429;Casares de las Hurdes;Cáceres;Extremadura;417;209;208
1210;Casariche;Sevilla;Andalucía;5456;2798;2658
1177;Casarrubios del Monte;Toledo;Castilla-La Mancha;5681;2984;2697
1544;Casarrubuelos;Madrid;Comunidad de Madrid;3778;1923;1855
6359;Casas Altas;Valencia/València;Comunidad Valenciana;131;74;57
5974;Casas Bajas;Valencia/València;Comunidad Valenciana;164;88;76
3354;Casas de Benítez;Cuenca;Castilla-La Mancha;852;424;428
5879;Casas de Don Antonio;Cáceres;Extremadura;174;86;88
5031;Casas de Don Gómez;Cáceres;Extremadura;289;155;134
2648;Casas de Don Pedro;Badajoz;Extremadura;1439;745;694
2908;Casas de Fernando Alonso;Cuenca;Castilla-La Mancha;1169;608;561
7918;Casas de Garcimolina;Cuenca;Castilla-La Mancha;29;19;10
6507;Casas de Guijarro;Cuenca;Castilla-La Mancha;117;63;54
3401;Casas de Haro;Cuenca;Castilla-La Mancha;823;437;386
2753;Casas de Juan Núñez;Albacete;Castilla-La Mancha;1307;686;621
4650;Casas de Lázaro;Albacete;Castilla-La Mancha;363;205;158
4347;Casas de los Pinos;Cuenca;Castilla-La Mancha;440;218;222
3958;Casas de Millán;Cáceres;Extremadura;567;289;278
6342;Casas de Miravete;Cáceres;Extremadura;132;83;49
5672;Casas de Reina;Badajoz;Extremadura;196;95;101
8084;Casas de San Galindo;Guadalajara;Castilla-La Mancha;16;13;3
3945;Casas de Ves;Albacete;Castilla-La Mancha;572;301;271
3957;Casas del Castañar;Cáceres;Extremadura;568;279;289
7241;Casas del Conde, Las;Salamanca;Castilla y León;69;32;37
3404;Casas del Monte;Cáceres;Extremadura;820;424;396
6941;Casas del Puerto;Ávila;Castilla y León;89;47;42
1378;Casas-Ibáñez;Albacete;Castilla-La Mancha;4538;2294;2244
5631;Casasbuenas;Toledo;Castilla-La Mancha;201;98;103
6808;Casaseca de Campeán;Zamora;Castilla y León;99;58;41
4531;Casaseca de las Chanas;Zamora;Castilla y León;390;205;185
1736;Casasimarro;Cuenca;Castilla-La Mancha;3084;1590;1494
7144;Casasola;Ávila;Castilla y León;75;45;30
5301;Casasola de Arión;Valladolid;Castilla y León;249;136;113
2704;Casatejada;Cáceres;Extremadura;1360;717;643
2653;Casavieja;Ávila;Castilla y León;1424;736;688
5147;Casbas de Huesca;Huesca;Aragón;270;146;124
7866;Cascajares de Bureba;Burgos;Castilla y León;32;14;18
7783;Cascajares de la Sierra;Burgos;Castilla y León;37;20;17
1518;Cascante;Navarra;Navarra;3864;1937;1927
7273;Cascante del Río;Teruel;Aragón;67;42;25
3171;Cáseda;Navarra;Navarra;974;489;485
5223;Caseres;Tarragona;Cataluña;259;129;130
3772;Casillas;Ávila;Castilla y León;638;334;304
4708;Casillas de Coria;Cáceres;Extremadura;349;170;179
5843;Casillas de Flores;Salamanca;Castilla y León;178;89;89
1863;Casinos;Valencia/València;Comunidad Valenciana;2777;1428;1349
5963;Casla;Segovia;Castilla y León;165;85;80
2579;Caso;Asturias;Principado de Asturias;1507;873;634
771;Caspe;Zaragoza;Aragón;9748;5093;4655
7059;Caspueñas;Guadalajara;Castilla-La Mancha;81;49;32
730;Cassà de la Selva;Girona;Cataluña;10380;5301;5079
2506;Casserres;Barcelona;Cataluña;1608;813;795
748;Castalla;Alicante/Alacant;Comunidad Valenciana;10124;5149;4975
3055;Castañar de Ibor;Cáceres;Extremadura;1054;549;505
4440;Castañares de Rioja;Rioja, La;La Rioja;415;199;216
1809;Castañeda;Cantabria;Cantabria;2914;1482;1432
5472;Castaño del Robledo;Huelva;Andalucía;223;121;102
5296;Cástaras;Granada;Andalucía;249;145;104
1454;Castejón;Navarra;Navarra;4163;2090;2073
6211;Castejón;Cuenca;Castilla-La Mancha;144;79;65
6927;Castejón de Alarba;Zaragoza;Aragón;91;58;33
7301;Castejón de Henares;Guadalajara;Castilla-La Mancha;65;40;25
6982;Castejón de las Armas;Zaragoza;Aragón;87;49;38
4076;Castejón de Monegros;Huesca;Aragón;522;283;239
3533;Castejón de Sos;Huesca;Aragón;747;381;366
7385;Castejón de Tornos;Teruel;Aragón;60;38;22
5580;Castejón de Valdejasa;Zaragoza;Aragón;210;105;105
4871;Castejón del Puente;Huesca;Aragón;318;167;151
6850;Castel de Cabra;Teruel;Aragón;96;53;43
6680;Castelflorite;Huesca;Aragón;106;54;52
8072;Castell de Cabres;Castellón/Castelló;Comunidad Valenciana;17;9;8
4307;Castell de Castells;Alicante/Alacant;Comunidad Valenciana;449;236;213
5516;Castell de Guadalest, el;Alicante/Alacant;Comunidad Valenciana;217;111;106
7246;Castell de l'Areny;Barcelona;Cataluña;68;38;30
5794;Castell de Mur;Lleida;Cataluña;183;104;79
704;Castell-Platja d'Aro;Girona;Cataluña;10860;5357;5503
964;Castell, Es;Balears, Illes;Islas Baleares;7434;3785;3649
7555;Castellanos de Castro;Burgos;Castilla y León;51;31;20
1904;Castellanos de Moriscos;Salamanca;Castilla y León;2677;1384;1293
3830;Castellanos de Villiquera;Salamanca;Castilla y León;617;337;280
6829;Castellanos de Zapardiel;Ávila;Castilla y León;97;54;43
1678;Castellar;Jaén;Andalucía;3314;1670;1644
1753;Castellar de la Frontera;Cádiz;Andalucía;3049;1528;1521
8015;Castellar de la Muela;Guadalajara;Castilla-La Mancha;22;13;9
6325;Castellar de la Ribera;Lleida;Cataluña;134;67;67
6029;Castellar de n'Hug;Barcelona;Cataluña;159;85;74
2304;Castellar de Santiago;Ciudad Real;Castilla-La Mancha;1897;962;935
5920;Castellar del Riu;Barcelona;Cataluña;169;94;75
333;Castellar del Vallès;Barcelona;Cataluña;24187;11948;12239
7425;Castellar, El;Teruel;Aragón;58;38;20
1582;Castellbell i el Vilar;Barcelona;Cataluña;3647;1863;1784
629;Castellbisbal;Barcelona;Cataluña;12390;6238;6152
3529;Castellcir;Barcelona;Cataluña;752;392;360
3202;Castelldans;Lleida;Cataluña;960;511;449
113;Castelldefels;Barcelona;Cataluña;67004;33018;33986
2084;Castellet i la Gornal;Barcelona;Cataluña;2292;1180;1112
3196;Castellfollit de la Roca;Girona;Cataluña;961;493;468
6134;Castellfollit de Riubregós;Barcelona;Cataluña;151;86;65
4364;Castellfollit del Boix;Barcelona;Cataluña;436;222;214
5790;Castellfort;Castellón/Castelló;Comunidad Valenciana;183;100;83
2207;Castellgalí;Barcelona;Cataluña;2062;1062;1000
2670;Castellnou de Bages;Barcelona;Cataluña;1397;732;665
3670;Castellnou de Seana;Lleida;Cataluña;683;361;322
3276;Castellnovo;Castellón/Castelló;Comunidad Valenciana;917;461;456
700;Castelló d'Empúries;Girona;Cataluña;10906;5508;5398
4030;Castelló de Farfanya;Lleida;Cataluña;536;288;248
2093;Castelló de Rugat;Valencia/València;Comunidad Valenciana;2274;1163;1111
3821;Castellolí;Barcelona;Cataluña;619;302;317
39;Castellón de la Plana/Castelló de la Plana;Castellón/Castelló;Comunidad Valenciana;171728;83072;88656
6187;Castellonet de la Conquesta;Valencia/València;Comunidad Valenciana;147;80;67
3678;Castellote;Teruel;Aragón;681;348;333
3127;Castellserà;Lleida;Cataluña;1003;506;497
1999;Castellterçol;Barcelona;Cataluña;2463;1236;1227
1830;Castellvell del Camp;Tarragona;Cataluña;2857;1438;1419
2558;Castellví de la Marca;Barcelona;Cataluña;1535;771;764
2310;Castellví de Rosanes;Barcelona;Cataluña;1884;931;953
6258;Castelnou;Teruel;Aragón;141;74;67
3416;Castelserás;Teruel;Aragón;815;430;385
4880;Castielfabib;Valencia/València;Comunidad Valenciana;317;168;149
5333;Castiello de Jaca;Huesca;Aragón;243;136;107
7017;Castigaleu;Huesca;Aragón;84;51;33
7953;Castil de Peones;Burgos;Castilla y León;27;14;13
7315;Castil de Vela;Palencia;Castilla y León;64;29;35
3216;Castilblanco;Badajoz;Extremadura;951;484;467
1322;Castilblanco de los Arroyos;Sevilla;Andalucía;4864;2443;2421
7795;Castildelgado;Burgos;Castilla y León;36;21;15
7239;Castilfalé;León;Castilla y León;69;40;29
7487;Castilforte;Guadalajara;Castilla-La Mancha;55;36;19
7926;Castilfrío de la Sierra;Soria;Castilla y León;29;20;9
5193;Castiliscar;Zaragoza;Aragón;263;137;126
5996;Castillazuelo;Huesca;Aragón;162;80;82
1846;Castilleja de Guzmán;Sevilla;Andalucía;2821;1447;1374
471;Castilleja de la Cuesta;Sevilla;Andalucía;17418;8442;8976
3797;Castilleja del Campo;Sevilla;Andalucía;629;323;306
2744;Castilléjar;Granada;Andalucía;1318;678;640
6032;Castillejo de Iniesta;Cuenca;Castilla-La Mancha;159;85;74
5482;Castillejo de Martín Viejo;Salamanca;Castilla y León;222;134;88
6307;Castillejo de Mesleón;Segovia;Castilla y León;136;75;61
6741;Castillejo de Robledo;Soria;Castilla y León;103;60;43
7936;Castillejo-Sierra;Cuenca;Castilla-La Mancha;28;15;13
3237;Castillo de Bayuela;Toledo;Castilla-La Mancha;938;465;473
6323;Castillo de Garcimuñoz;Cuenca;Castilla-La Mancha;134;78;56
2646;Castillo de las Guardas, El;Sevilla;Andalucía;1443;752;691
1480;Castillo de Locubín;Jaén;Andalucía;4058;2011;2047
6660;Castillo de Villamalefa;Castellón/Castelló;Comunidad Valenciana;107;72;35
8010;Castillo-Albaráñez;Cuenca;Castilla-La Mancha;22;10;12
4904;Castillonroy;Huesca;Aragón;313;164;149
8085;Castillonuevo;Navarra;Navarra;16;11;5
8122;Castilnuevo;Guadalajara;Castilla-La Mancha;8;5;3
6001;Castilruiz;Soria;Castilla y León;162;84;78
7676;Castraz;Salamanca;Castilla y León;44;29;15
4731;Castrejón de la Peña;Palencia;Castilla y León;345;188;157
5884;Castrejón de Trabancos;Valladolid;Castilla y León;174;85;89
2718;Castrelo de Miño;Ourense;Galicia;1349;683;666
3157;Castrelo do Val;Ourense;Galicia;984;499;485
2200;Castril;Granada;Andalucía;2070;1076;994
6480;Castrillo de Cabrera;León;Castilla y León;119;69;50
5596;Castrillo de Don Juan;Palencia;Castilla y León;207;117;90
6610;Castrillo de Duero;Valladolid;Castilla y León;111;66;45
6414;Castrillo de la Guareña;Zamora;Castilla y León;125;65;60
5848;Castrillo de la Reina;Burgos;Castilla y León;177;114;63
6045;Castrillo de la Valduerna;León;Castilla y León;158;70;88
3816;Castrillo de la Vega;Burgos;Castilla y León;621;340;281
6816;Castrillo de Onielo;Palencia;Castilla y León;98;52;46
7355;Castrillo de Riopisuerga;Burgos;Castilla y León;61;37;24
5880;Castrillo de Villavega;Palencia;Castilla y León;174;96;78
3443;Castrillo del Val;Burgos;Castilla y León;796;456;340
7556;Castrillo Mota de Judíos;Burgos;Castilla y León;51;27;24
5909;Castrillo-Tejeriego;Valladolid;Castilla y León;171;96;75
355;Castrillón;Asturias;Principado de Asturias;22376;10849;11527
2847;Castro Caldelas;Ourense;Galicia;1224;625;599
6427;Castro de Filabres;Almería;Andalucía;123;61;62
7889;Castro de Fuentidueña;Segovia;Castilla y León;31;20;11
1290;Castro de Rei;Lugo;Galicia;5052;2496;2556
924;Castro del Río;Córdoba;Andalucía;7809;3869;3940
231;Castro-Urdiales;Cantabria;Cantabria;32069;15866;16203
7371;Castrobol;Valladolid;Castilla y León;61;32;29
3191;Castrocalbón;León;Castilla y León;964;499;465
3496;Castrocontrigo;León;Castilla y León;765;412;353
6025;Castrodeza;Valladolid;Castilla y León;160;98;62
4233;Castrogonzalo;Zamora;Castilla y León;471;257;214
3444;Castrojeriz;Burgos;Castilla y León;796;417;379
7815;Castrojimeno;Segovia;Castilla y León;35;18;17
7516;Castromembibre;Valladolid;Castilla y León;54;38;16
5456;Castromocho;Palencia;Castilla y León;225;116;109
4860;Castromonte;Valladolid;Castilla y León;320;175;145
5443;Castronuevo;Zamora;Castilla y León;228;112;116
4627;Castronuevo de Esgueva;Valladolid;Castilla y León;369;197;172
3392;Castronuño;Valladolid;Castilla y León;828;418;410
2491;Castropodame;León;Castilla y León;1628;842;786
1646;Castropol;Asturias;Principado de Asturias;3402;1661;1741
6235;Castroponce;Valladolid;Castilla y León;143;78;65
7742;Castroserna de Abajo;Segovia;Castilla y León;40;23;17
7710;Castroserracín;Segovia;Castilla y León;42;24;18
6537;Castrotierra de Valmadrigal;León;Castilla y León;115;60;55
1927;Castroverde;Lugo;Galicia;2617;1355;1262
5050;Castroverde de Campos;Zamora;Castilla y León;287;150;137
5491;Castroverde de Cerrato;Valladolid;Castilla y León;221;139;82
7510;Castroviejo;Rioja, La;La Rioja;54;33;21
1147;Castuera;Badajoz;Extremadura;5880;2898;2982
1864;Catadau;Valencia/València;Comunidad Valenciana;2777;1378;1399
273;Catarroja;Valencia/València;Comunidad Valenciana;28120;13885;14235
3595;Catí;Castellón/Castelló;Comunidad Valenciana;721;362;359
1399;Catllar, El;Tarragona;Cataluña;4451;2309;2142
1666;Catoira;Pontevedra;Galicia;3335;1615;1720
856;Catral;Alicante/Alacant;Comunidad Valenciana;8639;4307;4332
758;Caudete;Albacete;Castilla-La Mancha;9963;5073;4890
3634;Caudete de las Fuentes;Valencia/València;Comunidad Valenciana;700;370;330
3712;Caudiel;Castellón/Castelló;Comunidad Valenciana;664;340;324
7627;Cava;Lleida;Cataluña;47;29;18
5339;Cavia;Burgos;Castilla y León;242;141;101
5779;Cayuela;Burgos;Castilla y León;184;99;85
2411;Cazalegas;Toledo;Castilla-La Mancha;1750;905;845
3399;Cazalilla;Jaén;Andalucía;824;404;420
1346;Cazalla de la Sierra;Sevilla;Andalucía;4718;2335;2383
962;Cazorla;Jaén;Andalucía;7441;3606;3835
7094;Cazurra;Zamora;Castilla y León;79;42;37
4445;Cea;León;Castilla y León;413;219;194
6182;Cebanico;León;Castilla y León;147;92;55
1699;Cebolla;Toledo;Castilla-La Mancha;3235;1615;1620
7520;Cebrecos;Burgos;Castilla y León;53;33;20
1726;Cebreros;Ávila;Castilla y León;3120;1614;1506
4302;Cebrones del Río;León;Castilla y León;451;248;203
2337;Ceclavín;Cáceres;Extremadura;1840;933;907
1047;Cedeira;Coruña, A;Galicia;6640;3292;3348
4346;Cedillo;Cáceres;Extremadura;440;231;209
6953;Cedillo de la Torre;Segovia;Castilla y León;89;48;41
1545;Cedillo del Condado;Toledo;Castilla-La Mancha;3762;1945;1817
3716;Cedrillas;Teruel;Aragón;664;325;339
948;Cee;Coruña, A;Galicia;7546;3605;3941
543;Cehegín;Murcia;Región de Murcia;14983;7537;7446
5576;Ceinos de Campos;Valladolid;Castilla y León;211;116;95
6428;Celada del Camino;Burgos;Castilla y León;123;59;64
4539;Celadas;Teruel;Aragón;388;221;167
1181;Celanova;Ourense;Galicia;5649;2676;2973
1950;Cella;Teruel;Aragón;2574;1329;1245
2290;Cellera de Ter, La;Girona;Cataluña;1946;965;981
8110;Cellorigo;Rioja, La;La Rioja;11;4;7
1211;Celrà;Girona;Cataluña;5452;2722;2730
2347;Cendea de Olza/Oltza Zendea;Navarra;Navarra;1831;901;930
7201;Cendejas de Enmedio;Guadalajara;Castilla-La Mancha;72;39;33
7994;Cendejas de la Torre;Guadalajara;Castilla-La Mancha;24;16;8
901;Cenes de la Vega;Granada;Andalucía;8002;3999;4003
2197;Cenicero;Rioja, La;La Rioja;2076;1061;1015
2228;Cenicientos;Madrid;Comunidad de Madrid;2033;1004;1029
2888;Cenizate;Albacete;Castilla-La Mancha;1181;597;584
2975;Cenlle;Ourense;Galicia;1120;561;559
969;Centelles;Barcelona;Cataluña;7404;3630;3774
6508;Centenera;Guadalajara;Castilla-La Mancha;117;64;53
8049;Centenera de Andaluz;Soria;Castilla y León;20;10;10
4919;Cepeda;Salamanca;Castilla y León;311;155;156
7167;Cepeda la Mora;Ávila;Castilla y León;74;42;32
7946;Cerbón;Soria;Castilla y León;28;19;9
1302;Cerceda;Coruña, A;Galicia;5001;2457;2544
1010;Cercedilla;Madrid;Comunidad de Madrid;7026;3463;3563
2940;Cercs;Barcelona;Cataluña;1145;577;568
4803;Cerdà;Valencia/València;Comunidad Valenciana;331;177;154
132;Cerdanyola del Vallès;Barcelona;Cataluña;57403;28038;29365
1171;Cerdedo-Cotobade;Pontevedra;Galicia;5699;2759;2940
2985;Cerdido;Coruña, A;Galicia;1113;547;566
7317;Cereceda de la Sierra;Salamanca;Castilla y León;64;33;31
5224;Cerecinos de Campos;Zamora;Castilla y León;259;143;116
6597;Cerecinos del Carrizal;Zamora;Castilla y León;112;65;47
7108;Cerezal de Peñahorcada;Salamanca;Castilla y León;78;40;38
5959;Cerezo;Cáceres;Extremadura;165;81;84
6592;Cerezo de Abajo;Segovia;Castilla y León;112;59;53
6308;Cerezo de Arriba;Segovia;Castilla y León;136;77;59
3986;Cerezo de Río Tirón;Burgos;Castilla y León;555;304;251
6554;Cernadilla;Zamora;Castilla y León;114;60;54
6894;Cerollera, La;Teruel;Aragón;93;58;35
6198;Cerralbo;Salamanca;Castilla y León;146;81;65
4417;Cerralbos, Los;Toledo;Castilla-La Mancha;421;233;188
7340;Cerratón de Juarros;Burgos;Castilla y León;62;40;22
2047;Cerro de Andévalo, El;Huelva;Andalucía;2364;1167;1197
4472;Cerro, El;Salamanca;Castilla y León;407;205;202
2729;Cervantes;Lugo;Galicia;1338;762;576
5087;Cervatos de la Cueza;Palencia;Castilla y León;280;153;127
826;Cervelló;Barcelona;Cataluña;9054;4529;4525
812;Cervera;Lleida;Cataluña;9180;4670;4510
6153;Cervera de Buitrago;Madrid;Comunidad de Madrid;150;92;58
5145;Cervera de la Cañada;Zaragoza;Aragón;271;151;120
4091;Cervera de los Montes;Toledo;Castilla-La Mancha;517;260;257
2062;Cervera de Pisuerga;Palencia;Castilla y León;2333;1161;1172
5487;Cervera del Llano;Cuenca;Castilla-La Mancha;221;116;105
3937;Cervera del Maestre;Castellón/Castelló;Comunidad Valenciana;575;286;289
2081;Cervera del Río Alhama;Rioja, La;La Rioja;2294;1182;1112
7862;Cerveruela;Zaragoza;Aragón;33;22;11
3769;Cervià de les Garrigues;Lleida;Cataluña;640;336;304
3183;Cervià de Ter;Girona;Cataluña;968;492;476
6939;Cervillego de la Cruz;Valladolid;Castilla y León;90;52;38
1437;Cervo;Lugo;Galicia;4227;2076;2151
4155;Cespedosa de Tormes;Salamanca;Castilla y León;495;267;228
3888;Cetina;Zaragoza;Aragón;593;309;284
80;Ceuta;Ceuta;Ceuta;84777;42912;41865
657;Ceutí;Murcia;Región de Murcia;11787;5938;5849
4165;Cevico de la Torre;Palencia;Castilla y León;491;246;245
5689;Cevico Navero;Palencia;Castilla y León;194;110;84
7051;Chagarcía Medianero;Salamanca;Castilla y León;82;45;37
6681;Chalamera;Huesca;Aragón;106;56;50
7129;Chamartín;Ávila;Castilla y León;76;45;31
4281;Chandrexa de Queixa;Ourense;Galicia;456;259;197
890;Chantada;Lugo;Galicia;8192;3943;4249
3560;Chañe;Segovia;Castilla y León;736;375;361
2063;Chapinería;Madrid;Comunidad de Madrid;2328;1181;1147
1190;Chauchina;Granada;Andalucía;5565;2754;2811
5075;Checa;Guadalajara;Castilla-La Mancha;282;172;110
2895;Cheles;Badajoz;Extremadura;1176;570;606
2008;Chella;Valencia/València;Comunidad Valenciana;2435;1205;1230
2601;Chelva;Valencia/València;Comunidad Valenciana;1489;766;723
8064;Chequilla;Guadalajara;Castilla-La Mancha;18;9;9
4230;Chera;Valencia/València;Comunidad Valenciana;474;256;218
5100;Chercos;Almería;Andalucía;278;142;136
865;Cheste;Valencia/València;Comunidad Valenciana;8494;4339;4155
7033;Chía;Huesca;Aragón;83;54;29
81;Chiclana de la Frontera;Cádiz;Andalucía;84489;42289;42200
3188;Chiclana de Segura;Jaén;Andalucía;965;489;476
1903;Chilches/Xilxes;Castellón/Castelló;Comunidad Valenciana;2679;1383;1296
3828;Chillarón de Cuenca;Cuenca;Castilla-La Mancha;617;322;295
6960;Chillarón del Rey;Guadalajara;Castilla-La Mancha;88;49;39
2362;Chillón;Ciudad Real;Castilla-La Mancha;1816;877;939
2650;Chilluévar;Jaén;Andalucía;1434;692;742
1593;Chiloeches;Guadalajara;Castilla-La Mancha;3579;1862;1717
2803;Chimeneas;Granada;Andalucía;1257;657;600
4523;Chimillas;Huesca;Aragón;393;200;193
1443;Chinchilla de Monte-Aragón;Albacete;Castilla-La Mancha;4206;2196;2010
1236;Chinchón;Madrid;Comunidad de Madrid;5331;2682;2649
431;Chipiona;Cádiz;Andalucía;19123;9586;9537
4073;Chiprana;Zaragoza;Aragón;523;277;246
2616;Chirivel;Almería;Andalucía;1472;748;724
539;Chiva;Valencia/València;Comunidad Valenciana;15123;7740;7383
6728;Chodes;Zaragoza;Aragón;104;58;46
6580;Chodos/Xodos;Castellón/Castelló;Comunidad Valenciana;112;69;43
5037;Chóvar;Castellón/Castelló;Comunidad Valenciana;288;150;138
1945;Chozas de Abajo;León;Castilla y León;2581;1347;1234
1498;Chozas de Canales;Toledo;Castilla-La Mancha;3966;2065;1901
2126;Chucena;Huelva;Andalucía;2222;1131;1091
5238;Chueca;Toledo;Castilla-La Mancha;257;134;123
3711;Chulilla;Valencia/València;Comunidad Valenciana;665;355;310
7433;Chumillas;Cuenca;Castilla-La Mancha;57;32;25
537;Churriana de la Vega;Granada;Andalucía;15200;7531;7669
7148;Ciadoncha;Burgos;Castilla y León;75;44;31
7980;Cidamón;Rioja, La;La Rioja;25;13;12
4968;Cidones;Soria;Castilla y León;301;183;118
321;Ciempozuelos;Madrid;Comunidad de Madrid;24592;12363;12229
7937;Cierva, La;Cuenca;Castilla-La Mancha;28;16;12
211;Cieza;Murcia;Región de Murcia;34988;17533;17455
4020;Cieza;Cantabria;Cantabria;538;275;263
2482;Cifuentes;Guadalajara;Castilla-La Mancha;1645;851;794
1257;Cigales;Valladolid;Castilla y León;5235;2662;2573
8058;Cigudosa;Soria;Castilla y León;19;12;7
4628;Ciguñuela;Valladolid;Castilla y León;369;194;175
7568;Cihuela;Soria;Castilla y León;51;28;23
5842;Cihuri;Rioja, La;La Rioja;178;93;85
1672;Cijuela;Granada;Andalucía;3322;1700;1622
6885;Cillán;Ávila;Castilla y León;93;56;37
7867;Cillaperlata;Burgos;Castilla y León;32;22;10
2492;Cilleros;Cáceres;Extremadura;1624;818;806
7970;Cilleros de la Bastida;Salamanca;Castilla y León;26;12;14
5508;Cilleruelo de Abajo;Burgos;Castilla y León;218;123;95
7665;Cilleruelo de Arriba;Burgos;Castilla y León;44;23;21
7851;Cilleruelo de San Mamés;Segovia;Castilla y León;33;20;13
2755;Cillorigo de Liébana;Cantabria;Cantabria;1305;680;625
4258;Cimanes de la Vega;León;Castilla y León;463;244;219
3587;Cimanes del Tejar;León;Castilla y León;724;390;334
6837;Cimballa;Zaragoza;Aragón;97;48;49
6695;Cinco Olivas;Zaragoza;Aragón;106;51;55
8016;Cincovillas;Guadalajara;Castilla-La Mancha;22;10;12
4527;Cinctorres;Castellón/Castelló;Comunidad Valenciana;391;192;199
912;Cintruénigo;Navarra;Navarra;7903;4071;3832
5141;Cipérez;Salamanca;Castilla y León;271;142;129
5627;Cirat;Castellón/Castelló;Comunidad Valenciana;201;109;92
4182;Cirauqui/Zirauki;Navarra;Navarra;487;254;233
6968;Ciria;Soria;Castilla y León;88;45;43
6088;Ciriza/Ziritza;Navarra;Navarra;155;72;83
6443;Ciruelas;Guadalajara;Castilla-La Mancha;122;68;54
3995;Ciruelos;Toledo;Castilla-La Mancha;551;293;258
6800;Ciruelos de Cervera;Burgos;Castilla y León;99;58;41
7921;Ciruelos del Pinar;Guadalajara;Castilla-La Mancha;29;18;11
6116;Cirueña;Rioja, La;La Rioja;153;98;55
8025;Cirujales del Río;Soria;Castilla y León;22;16;6
6749;Cisla;Ávila;Castilla y León;102;50;52
4369;Cisneros;Palencia;Castilla y León;435;213;222
5074;Cistella;Girona;Cataluña;282;138;144
828;Cistérniga;Valladolid;Castilla y León;9034;4569;4465
1723;Cistierna;León;Castilla y León;3135;1548;1587
101;Ciudad Real;Ciudad Real;Castilla-La Mancha;74746;35401;39345
632;Ciudad Rodrigo;Salamanca;Castilla y León;12344;5932;6412
256;Ciutadella de Menorca;Balears, Illes;Islas Baleares;29840;14802;15038
5589;Ciutadilla;Lleida;Cataluña;208;111;97
1512;Cizur;Navarra;Navarra;3888;1999;1889
7293;Clarés de Ribota;Zaragoza;Aragón;66;37;29
6058;Clariana de Cardener;Lleida;Cataluña;157;82;75
5217;Clavijo;Rioja, La;La Rioja;260;156;104
1677;Coaña;Asturias;Principado de Asturias;3315;1607;1708
5901;Cóbdar;Almería;Andalucía;171;99;72
2108;Cobeja;Toledo;Castilla-La Mancha;2255;1163;1092
966;Cobeña;Madrid;Comunidad de Madrid;7428;3623;3805
6546;Cobeta;Guadalajara;Castilla-La Mancha;114;58;56
1419;Cobisa;Toledo;Castilla-La Mancha;4310;2164;2146
6230;Cobos de Cerrato;Palencia;Castilla y León;143;80;63
7828;Cobos de Fuentidueña;Segovia;Castilla y León;34;16;18
3932;Cobreros;Zamora;Castilla y León;579;313;266
2397;Coca;Segovia;Castilla y León;1763;891;872
6644;Coca de Alba;Salamanca;Castilla y León;109;52;57
669;Cocentaina;Alicante/Alacant;Comunidad Valenciana;11511;5868;5643
5634;Codo;Zaragoza;Aragón;201;106;95
4778;Codoñera, La;Teruel;Aragón;336;177;159
4822;Codorniz;Segovia;Castilla y León;327;166;161
5394;Codos;Zaragoza;Aragón;234;150;84
2198;Codosera, La;Badajoz;Extremadura;2075;1097;978
2961;Cofrentes;Valencia/València;Comunidad Valenciana;1130;574;556
6261;Cogeces de Íscar;Valladolid;Castilla y León;141;69;72
3667;Cogeces del Monte;Valladolid;Castilla y León;685;370;315
7979;Cogollor;Guadalajara;Castilla-La Mancha;25;16;9
3977;Cogollos;Burgos;Castilla y León;557;302;255
3694;Cogollos de Guadix;Granada;Andalucía;673;375;298
2230;Cogollos de la Vega;Granada;Andalucía;2031;1018;1013
4015;Cogolludo;Guadalajara;Castilla-La Mancha;540;314;226
6046;Cogul, El;Lleida;Cataluña;158;88;70
361;Coín;Málaga;Andalucía;22147;11094;11053
2353;Coirós;Coruña, A;Galicia;1824;906;918
4317;Colera;Girona;Cataluña;448;223;225
1752;Coles;Ourense;Galicia;3050;1536;1514
4774;Colilla, La;Ávila;Castilla y León;336;175;161
866;Colindres;Cantabria;Cantabria;8484;4178;4306
3996;Coll de Nargó;Lleida;Cataluña;550;285;265
5930;Collado de Contreras;Ávila;Castilla y León;168;85;83
5679;Collado de la Vera;Cáceres;Extremadura;195;106;89
7864;Collado del Mirón;Ávila;Castilla y León;32;21;11
6411;Collado Hermoso;Segovia;Castilla y León;125;63;62
1016;Collado Mediano;Madrid;Comunidad de Madrid;6958;3441;3517
119;Collado Villalba;Madrid;Comunidad de Madrid;63679;30947;32732
6762;Collazos de Boedo;Palencia;Castilla y León;102;60;42
1395;Collbató;Barcelona;Cataluña;4466;2320;2146
5866;Colldejou;Tarragona;Cataluña;176;93;83
4744;Collsuspina;Barcelona;Cataluña;342;174;168
1656;Colmenar;Málaga;Andalucía;3376;1728;1648
5815;Colmenar de Montemayor;Salamanca;Castilla y León;182;105;77
899;Colmenar de Oreja;Madrid;Comunidad de Madrid;8032;4052;3980
2428;Colmenar del Arroyo;Madrid;Comunidad de Madrid;1725;893;832
145;Colmenar Viejo;Madrid;Comunidad de Madrid;50752;25045;25707
816;Colmenarejo;Madrid;Comunidad de Madrid;9130;4471;4659
2752;Colomera;Granada;Andalucía;1309;677;632
5856;Colomers;Girona;Cataluña;176;87;89
1694;Colunga;Asturias;Principado de Asturias;3257;1599;1658
6621;Colungo;Huesca;Aragón;110;62;48
5176;Coma i la Pedra, La;Lleida;Cataluña;265;157;108
2747;Comares;Málaga;Andalucía;1315;704;611
2163;Comillas;Cantabria;Cantabria;2141;1010;1131
1507;Cómpeta;Málaga;Andalucía;3922;1958;1964
4426;Conca de Dalt;Lleida;Cataluña;418;213;205
6936;Condado de Castilnovo;Segovia;Castilla y León;90;50;40
2727;Condado de Treviño;Burgos;Castilla y León;1342;745;597
8097;Condemios de Abajo;Guadalajara;Castilla-La Mancha;14;9;5
6430;Condemios de Arriba;Guadalajara;Castilla-La Mancha;123;69;54
6742;Conesa;Tarragona;Cataluña;103;54;49
5739;Confrides;Alicante/Alacant;Comunidad Valenciana;187;106;81
2613;Congosto;León;Castilla y León;1475;743;732
6115;Congosto de Valdavia;Palencia;Castilla y León;153;91;62
8073;Congostrina;Guadalajara;Castilla-La Mancha;17;13;4
352;Conil de la Frontera;Cádiz;Andalucía;22529;11345;11184
4576;Conquista;Córdoba;Andalucía;379;186;193
5768;Conquista de la Sierra;Cáceres;Extremadura;185;108;77
1482;Consell;Balears, Illes;Islas Baleares;4053;2024;2029
1061;Constantí;Tarragona;Cataluña;6540;3398;3142
1141;Constantina;Sevilla;Andalucía;5896;2916;2980
6650;Constanzana;Ávila;Castilla y León;108;63;45
754;Consuegra;Toledo;Castilla-La Mancha;9998;5061;4937
7792;Contamina;Zaragoza;Aragón;37;21;16
7115;Contreras;Burgos;Castilla y León;77;49;28
5751;Coomonte;Zamora;Castilla y León;187;102;85
7939;Copernal;Guadalajara;Castilla-La Mancha;28;18;10
4922;Copons;Barcelona;Cataluña;310;152;158
6669;Corbalán;Teruel;Aragón;107;56;51
1733;Corbera;Valencia/València;Comunidad Valenciana;3100;1547;1553
3111;Corbera d'Ebre;Tarragona;Cataluña;1016;531;485
547;Corbera de Llobregat;Barcelona;Cataluña;14822;7449;7373
5650;Corbillos de los Oteros;León;Castilla y León;199;112;87
2645;Corbins;Lleida;Cataluña;1444;787;657
2790;Corçà;Girona;Cataluña;1267;646;621
5632;Corcos;Valladolid;Castilla y León;201;111;90
2519;Corcubión;Coruña, A;Galicia;1589;769;820
12;Córdoba;Córdoba;Andalucía;325701;156355;169346
3281;Cordobilla de Lácara;Badajoz;Extremadura;909;472;437
6496;Cordovilla;Salamanca;Castilla y León;118;61;57
6641;Cordovilla la Real;Palencia;Castilla y León;109;63;46
6075;Cordovín;Rioja, La;La Rioja;156;76;80
4709;Corduente;Guadalajara;Castilla-La Mancha;349;191;158
907;Corella;Navarra;Navarra;7971;4007;3964
5235;Corera;Rioja, La;La Rioja;257;132;125
3065;Coreses;Zamora;Castilla y León;1047;543;504
1625;Corgo, O;Lugo;Galicia;3481;1773;1708
623;Coria;Cáceres;Extremadura;12478;6134;6344
244;Coria del Río;Sevilla;Andalucía;30777;15336;15441
2813;Coripe;Sevilla;Andalucía;1251;611;640
1119;Coristanco;Coruña, A;Galicia;6074;2895;3179
4916;Cornago;Rioja, La;La Rioja;312;181;131
73;Cornellà de Llobregat;Barcelona;Cataluña;88592;42945;45647
2046;Cornellà del Terri;Girona;Cataluña;2364;1197;1167
3233;Cornudella de Montsant;Tarragona;Cataluña;941;505;436
2154;Coronada, La;Badajoz;Extremadura;2162;1057;1105
1341;Coronil, El;Sevilla;Andalucía;4746;2386;2360
3609;Corpa;Madrid;Comunidad de Madrid;713;372;341
7723;Corporales;Rioja, La;La Rioja;41;25;16
1231;Corral de Almaguer;Toledo;Castilla-La Mancha;5352;2763;2589
7123;Corral de Ayllón;Segovia;Castilla y León;77;45;32
2972;Corral de Calatrava;Ciudad Real;Castilla-La Mancha;1123;545;578
4836;Corral-Rubio;Albacete;Castilla-La Mancha;324;174;150
706;Corrales de Buelna, Los;Cantabria;Cantabria;10841;5290;5551
6712;Corrales de Duero;Valladolid;Castilla y León;105;60;45
3198;Corrales del Vino;Zamora;Castilla y León;961;474;487
1502;Corrales, Los;Sevilla;Andalucía;3941;2013;1928
2849;Corte de Peleas;Badajoz;Extremadura;1222;602;620
3998;Corteconcepción;Huelva;Andalucía;548;287;261
3015;Cortegada;Ourense;Galicia;1085;539;546
1353;Cortegana;Huelva;Andalucía;4666;2368;2298
4975;Cortelazor;Huelva;Andalucía;299;140;159
1720;Cortes;Navarra;Navarra;3151;1598;1553
7370;Cortes de Aragón;Teruel;Aragón;61;28;33
4867;Cortes de Arenoso;Castellón/Castelló;Comunidad Valenciana;318;172;146
2319;Cortes de Baza;Granada;Andalucía;1869;931;938
1732;Cortes de la Frontera;Málaga;Andalucía;3101;1592;1509
3419;Cortes de Pallás;Valencia/València;Comunidad Valenciana;814;447;367
3138;Cortes y Graena;Granada;Andalucía;996;528;468
3304;Cortijos, Los;Ciudad Real;Castilla-La Mancha;884;468;416
3299;Corullón;León;Castilla y León;887;447;440
6635;Coruña del Conde;Burgos;Castilla y León;109;68;41
18;Coruña, A;Coruña, A;Galicia;245711;113900;131811
522;Corvera de Asturias;Asturias;Principado de Asturias;15549;7622;7927
2221;Corvera de Toranzo;Cantabria;Cantabria;2039;1036;1003
7589;Cosa;Teruel;Aragón;50;32;18
7089;Coscurita;Soria;Castilla y León;79;49;30
89;Coslada;Madrid;Comunidad de Madrid;81661;39988;41673
1389;Cospeito;Lugo;Galicia;4484;2180;2304
2767;Costitx;Balears, Illes;Islas Baleares;1288;638;650
4067;Costur;Castellón/Castelló;Comunidad Valenciana;524;277;247
4648;Cosuenda;Zaragoza;Aragón;364;193;171
6746;Cotanes del Monte;Zamora;Castilla y León;103;57;46
4794;Cotes;Valencia/València;Comunidad Valenciana;333;171;162
6426;Cotillas;Albacete;Castilla-La Mancha;123;64;59
2457;Covaleda;Soria;Castilla y León;1680;868;812
3993;Covarrubias;Burgos;Castilla y León;552;296;256
2031;Covelo;Pontevedra;Galicia;2396;1214;1182
2354;Coves de Vinromà, les;Castellón/Castelló;Comunidad Valenciana;1823;921;902
983;Cox;Alicante/Alacant;Comunidad Valenciana;7297;3722;3575
3181;Cózar;Ciudad Real;Castilla-La Mancha;969;482;487
6357;Cozuelos de Fuentidueña;Segovia;Castilla y León;131;72;59
2248;Crecente;Pontevedra;Galicia;2012;974;1038
1585;Creixell;Tarragona;Cataluña;3642;1845;1797
4006;Crémenes;León;Castilla y León;544;292;252
5320;Crespià;Girona;Cataluña;246;127;119
4152;Crespos;Ávila;Castilla y León;495;265;230
3959;Cretas;Teruel;Aragón;567;290;277
267;Crevillent;Alicante/Alacant;Comunidad Valenciana;28952;14627;14325
3992;Cristina;Badajoz;Extremadura;552;283;269
6062;Cristóbal;Salamanca;Castilla y León;157;90;67
7348;Crivillén;Teruel;Aragón;62;32;30
2774;Cruïlles, Monells i Sant Sadurní de l'Heura;Girona;Cataluña;1279;640;639
3366;Cuacos de Yuste;Cáceres;Extremadura;841;439;402
2254;Cuadros;León;Castilla y León;2001;1007;994
2460;Cualedro;Ourense;Galicia;1679;866;813
596;Cuarte de Huerva;Zaragoza;Aragón;13303;6792;6511
7695;Cuba, La;Teruel;Aragón;43;26;17
1075;Cubas de la Sagra;Madrid;Comunidad de Madrid;6413;3202;3211
6097;Cubel;Zaragoza;Aragón;155;75;80
531;Cubelles;Barcelona;Cataluña;15329;7687;7642
4740;Cubells;Lleida;Cataluña;343;180;163
7855;Cubilla;Soria;Castilla y León;33;20;13
7359;Cubillas de Cerrato;Palencia;Castilla y León;61;36;25
6253;Cubillas de los Oteros;León;Castilla y León;141;81;60
4538;Cubillas de Rueda;León;Castilla y León;388;206;182
4830;Cubillas de Santa Marta;Valladolid;Castilla y León;326;191;135
7190;Cubillo;Segovia;Castilla y León;73;44;29
6455;Cubillo de Uceda, El;Guadalajara;Castilla-La Mancha;121;65;56
6899;Cubillo del Campo;Burgos;Castilla y León;92;51;41
4908;Cubillos;Zamora;Castilla y León;313;154;159
2363;Cubillos del Sil;León;Castilla y León;1816;952;864
7426;Cubla;Teruel;Aragón;58;39;19
6555;Cubo de Benavente;Zamora;Castilla y León;114;63;51
6811;Cubo de Bureba;Burgos;Castilla y León;98;54;44
4348;Cubo de Don Sancho, El;Salamanca;Castilla y León;440;233;207
5785;Cubo de la Solana;Soria;Castilla y León;184;101;83
4861;Cubo de Tierra del Vino, El;Zamora;Castilla y León;320;168;152
7111;Cucalón;Teruel;Aragón;78;47;31
1303;Cudillero;Asturias;Principado de Asturias;4987;2448;2539
7007;Cuelgamures;Zamora;Castilla y León;85;53;32
781;Cuéllar;Segovia;Castilla y León;9583;4843;4740
134;Cuenca;Cuenca;Castilla-La Mancha;54690;26049;28641
5468;Cuenca de Campos;Valladolid;Castilla y León;224;115;109
7726;Cuerlas, Las;Zaragoza;Aragón;41;21;20
2764;Cuerva;Toledo;Castilla-La Mancha;1291;670;621
859;Cuervo de Sevilla, El;Sevilla;Andalucía;8610;4329;4281
7112;Cuervo, El;Teruel;Aragón;78;42;36
7191;Cueva de Ágreda;Soria;Castilla y León;73;46;27
6440;Cueva de Roa, La;Burgos;Castilla y León;122;61;61
7919;Cueva del Hierro;Cuenca;Castilla-La Mancha;29;21;8
2672;Cuevas Bajas;Málaga;Andalucía;1395;696;699
6407;Cuevas de Almudén;Teruel;Aragón;126;71;55
6309;Cuevas de Provanco;Segovia;Castilla y León;136;77;59
7638;Cuevas de San Clemente;Burgos;Castilla y León;46;18;28
1581;Cuevas de San Marcos;Málaga;Andalucía;3648;1838;1810
566;Cuevas del Almanzora;Almería;Andalucía;14081;7343;6738
2520;Cuevas del Becerro;Málaga;Andalucía;1589;785;804
2419;Cuevas del Campo;Granada;Andalucía;1735;873;862
4185;Cuevas del Valle;Ávila;Castilla y León;484;267;217
6351;Cuevas Labradas;Teruel;Aragón;132;72;60
4153;Culla;Castellón/Castelló;Comunidad Valenciana;495;252;243
1464;Cúllar;Granada;Andalucía;4129;2054;2075
965;Cúllar Vega;Granada;Andalucía;7429;3779;3650
362;Cullera;Valencia/València;Comunidad Valenciana;22145;11037;11108
251;Culleredo;Coruña, A;Galicia;30402;14685;15717
3359;Cumbre, La;Cáceres;Extremadura;848;430;418
7466;Cumbres de Enmedio;Huelva;Andalucía;56;34;22
4566;Cumbres de San Bartolomé;Huelva;Andalucía;381;186;195
2407;Cumbres Mayores;Huelva;Andalucía;1755;871;884
607;Cunit;Tarragona;Cataluña;12952;6347;6605
1351;Cuntis;Pontevedra;Galicia;4677;2218;2459
6434;Curiel de Duero;Valladolid;Castilla y León;123;77;46
1493;Curtis;Coruña, A;Galicia;3983;1981;2002
3853;Cútar;Málaga;Andalucía;607;309;298
4158;Cuzcurrita de Río Tirón;Rioja, La;La Rioja;493;271;222
742;Daganzo de Arriba;Madrid;Comunidad de Madrid;10205;5079;5126
460;Daimiel;Ciudad Real;Castilla-La Mancha;17929;8970;8959
1728;Daimús;Valencia/València;Comunidad Valenciana;3117;1538;1579
1492;Dalías;Almería;Andalucía;4006;1988;2018
4001;Darnius;Girona;Cataluña;546;273;273
2269;Daroca;Zaragoza;Aragón;1983;972;1011
7543;Daroca de Rioja;Rioja, La;La Rioja;52;34;18
2513;Darro;Granada;Andalucía;1599;814;785
5263;Das;Girona;Cataluña;253;131;122
2417;Daya Nueva;Alicante/Alacant;Comunidad Valenciana;1737;852;885
3654;Daya Vieja;Alicante/Alacant;Comunidad Valenciana;690;354;336
1209;Deba;Gipuzkoa;País Vasco;5459;2711;2748
3265;Degaña;Asturias;Principado de Asturias;921;478;443
6334;Dehesa de Montejo;Palencia;Castilla y León;133;78;55
7580;Dehesa de Romanos;Palencia;Castilla y León;50;30;20
4421;Dehesas de Guadix;Granada;Andalucía;419;206;213
3625;Dehesas Viejas;Granada;Andalucía;705;363;342
3827;Deià;Balears, Illes;Islas Baleares;617;299;318
1920;Deifontes;Granada;Andalucía;2627;1325;1302
3616;Deleitosa;Cáceres;Extremadura;709;355;354
672;Deltebre;Tarragona;Cataluña;11482;5788;5694
166;Dénia;Alicante/Alacant;Comunidad Valenciana;42166;20419;21747
1050;Derio;Bizkaia;País Vasco;6631;3256;3375
6429;Descargamaría;Cáceres;Extremadura;123;72;51
7084;Desojo;Navarra;Navarra;79;44;35
4211;Destriana;León;Castilla y León;479;224;255
7090;Dévanos;Soria;Castilla y León;79;45;34
5550;Deza;Soria;Castilla y León;214;112;102
3859;Dicastillo;Navarra;Navarra;604;305;299
6276;Diego del Carpio;Ávila;Castilla y León;139;79;60
3498;Diezma;Granada;Andalucía;764;402;362
2213;Dílar;Granada;Andalucía;2054;1032;1022
2649;Dima;Bizkaia;País Vasco;1436;741;695
6461;Dios le Guarde;Salamanca;Castilla y León;121;68;53
1868;Dodro;Coruña, A;Galicia;2768;1344;1424
3814;Dólar;Granada;Andalucía;622;333;289
959;Dolores;Alicante/Alacant;Comunidad Valenciana;7470;3740;3730
3623;Domeño;Valencia/València;Comunidad Valenciana;708;357;351
7982;Domingo García;Segovia;Castilla y León;25;16;9
4611;Domingo Pérez;Toledo;Castilla-La Mancha;372;192;180
3296;Domingo Pérez de Granada;Granada;Andalucía;890;464;426
3456;Don Álvaro;Badajoz;Extremadura;788;405;383
195;Don Benito;Badajoz;Extremadura;37151;18362;18789
4377;Donamaria;Navarra;Navarra;433;218;215
2424;Doneztebe/Santesteban;Navarra;Navarra;1726;880;846
6925;Donhierro;Segovia;Castilla y León;91;47;44
7096;Donjimeno;Ávila;Castilla y León;78;44;34
34;Donostia/San Sebastián;Gipuzkoa;País Vasco;187415;88306;99109
7821;Donvidas;Ávila;Castilla y León;34;18;16
1361;Doña Mencía;Córdoba;Andalucía;4638;2249;2389
7216;Doñinos de Ledesma;Salamanca;Castilla y León;71;37;34
2188;Doñinos de Salamanca;Salamanca;Castilla y León;2097;1105;992
4595;Dos Aguas;Valencia/València;Comunidad Valenciana;376;209;167
49;Dos Hermanas;Sevilla;Andalucía;133968;65828;68140
2024;Dos Torres;Córdoba;Andalucía;2411;1202;1209
2125;Dosbarrios;Toledo;Castilla-La Mancha;2223;1137;1086
1207;Dosrius;Barcelona;Cataluña;5481;2780;2701
3017;Dozón;Pontevedra;Galicia;1082;566;516
4636;Driebes;Guadalajara;Castilla-La Mancha;366;198;168
4804;Dúdar;Granada;Andalucía;330;173;157
1929;Dueñas;Palencia;Castilla y León;2612;1329;1283
5328;Duesaigües;Tarragona;Cataluña;245;140;105
1781;Dumbría;Coruña, A;Galicia;2983;1434;1549
257;Durango;Bizkaia;País Vasco;29791;14554;15237
1011;Dúrcal;Granada;Andalucía;7015;3482;3533
6679;Durón;Guadalajara;Castilla-La Mancha;106;56;50
5832;Duruelo;Segovia;Castilla y León;180;108;72
3011;Duruelo de la Sierra;Soria;Castilla y León;1090;556;534
3400;Ea;Bizkaia;País Vasco;823;431;392
7153;Echarri/Etxarri;Navarra;Navarra;75;36;39
176;Écija;Sevilla;Andalucía;39873;19707;20166
282;Eibar;Gipuzkoa;País Vasco;27522;13391;14131
149;Eivissa;Balears, Illes;Islas Baleares;49783;25031;24752
490;Ejea de los Caballeros;Zaragoza;Aragón;16783;8562;8221
6402;Éjeme;Salamanca;Castilla y León;126;72;54
83;Ejido, El;Almería;Andalucía;83594;43596;39998
5877;Ejulve;Teruel;Aragón;175;90;85
4703;Elantxobe;Bizkaia;País Vasco;350;176;174
3872;Elburgo/Burgelu;Araba/Álava;País Vasco;599;320;279
1591;Elche de la Sierra;Albacete;Castilla-La Mancha;3585;1787;1798
19;Elche/Elx;Alicante/Alacant;Comunidad Valenciana;232517;115151;117366
3121;Elciego;Araba/Álava;País Vasco;1005;502;503
138;Elda;Alicante/Alacant;Comunidad Valenciana;52618;25639;26979
5290;Elduain;Gipuzkoa;País Vasco;250;125;125
2949;Elgeta;Gipuzkoa;País Vasco;1136;581;555
662;Elgoibar;Gipuzkoa;País Vasco;11613;5739;5874
5499;Elgorriaga;Navarra;Navarra;220;111;109
453;Eliana, l';Valencia/València;Comunidad Valenciana;18235;8875;9360
3283;Eljas;Cáceres;Extremadura;908;469;439
973;Elorrio;Bizkaia;País Vasco;7372;3634;3738
4789;Elvillar/Bilar;Araba/Álava;País Vasco;333;162;171
7845;Embid;Guadalajara;Castilla-La Mancha;33;18;15
7793;Embid de Ariza;Zaragoza;Aragón;37;20;17
3662;Emperador;Valencia/València;Comunidad Valenciana;687;359;328
6588;Encina de San Silvestre;Salamanca;Castilla y León;112;55;57
6805;Encina, La;Salamanca;Castilla y León;99;59;40
5847;Encinacorba;Zaragoza;Aragón;178;97;81
7678;Encinas;Segovia;Castilla y León;44;22;22
3787;Encinas de Abajo;Salamanca;Castilla y León;633;339;294
5378;Encinas de Arriba;Salamanca;Castilla y León;237;120;117
5309;Encinas de Esgueva;Valladolid;Castilla y León;248;147;101
2110;Encinas Reales;Córdoba;Andalucía;2254;1115;1139
2756;Encinasola;Huelva;Andalucía;1305;655;650
5970;Encinasola de los Comendadores;Salamanca;Castilla y León;164;92;72
3618;Encinedo;León;Castilla y León;709;375;334
4951;Encinillas;Segovia;Castilla y León;304;168;136
7748;Encío;Burgos;Castilla y León;39;20;19
6023;Enciso;Rioja, La;La Rioja;160;100;60
5514;Endrinal;Salamanca;Castilla y León;218;118;100
5054;Enériz/Eneritz;Navarra;Navarra;286;147;139
1340;Enguera;Valencia/València;Comunidad Valenciana;4752;2366;2386
4879;Enguídanos;Cuenca;Castilla-La Mancha;317;167;150
4248;Enix;Almería;Andalucía;466;259;207
3300;Ènova, l';Valencia/València;Comunidad Valenciana;887;453;434
6080;Entrala;Zamora;Castilla y León;156;85;71
1269;Entrambasaguas;Cantabria;Cantabria;5163;2590;2573
2557;Entrena;Rioja, La;La Rioja;1536;801;735
2944;Entrimo;Ourense;Galicia;1140;538;602
3994;Entrín Bajo;Badajoz;Extremadura;551;280;271
1411;Épila;Zaragoza;Aragón;4386;2282;2104
326;Erandio;Bizkaia;País Vasco;24350;11808;12542
6138;Eratsun;Navarra;Navarra;151;92;59
4274;Ercina, La;León;Castilla y León;457;240;217
5323;Ereño;Bizkaia;País Vasco;245;140;105
4610;Ergoiena;Navarra;Navarra;372;202;170
4747;Erla;Zaragoza;Aragón;342;175;167
514;Ermua;Bizkaia;País Vasco;15880;7909;7971
178;Errenteria;Gipuzkoa;País Vasco;39471;19110;20361
3912;Errezil;Gipuzkoa;País Vasco;585;307;278
2717;Erriberabeitia;Araba/Álava;País Vasco;1350;724;626
3463;Erriberagoitia/Ribera Alta;Araba/Álava;País Vasco;785;453;332
4209;Errigoiti;Bizkaia;País Vasco;479;263;216
3439;Erro;Navarra;Navarra;800;449;351
5700;Erustes;Toledo;Castilla-La Mancha;193;101;92
2087;Escacena del Campo;Huelva;Andalucía;2284;1112;1172
733;Escala, L';Girona;Cataluña;10339;5267;5072
3477;Escalante;Cantabria;Cantabria;779;399;380
1698;Escalona;Toledo;Castilla-La Mancha;3241;1679;1562
4142;Escalona del Prado;Segovia;Castilla y León;499;260;239
2652;Escalonilla;Toledo;Castilla-La Mancha;1427;716;711
7330;Escamilla;Guadalajara;Castilla-La Mancha;63;35;28
3219;Escañuela;Jaén;Andalucía;950;468;482
4980;Escarabajosa de Cabezas;Segovia;Castilla y León;298;163;135
5769;Escariche;Guadalajara;Castilla-La Mancha;185;113;72
3057;Escatrón;Zaragoza;Aragón;1051;522;529
7752;Escobar de Campos;León;Castilla y León;39;22;17
5949;Escobar de Polendos;Segovia;Castilla y León;167;88;79
8041;Escobosa de Almazán;Soria;Castilla y León;21;14;7
7439;Escopete;Guadalajara;Castilla-La Mancha;57;24;33
5558;Escorca;Balears, Illes;Islas Baleares;212;129;83
507;Escorial, El;Madrid;Comunidad de Madrid;16162;8004;8158
6310;Escorihuela;Teruel;Aragón;136;67;69
3355;Escucha;Teruel;Aragón;852;448;404
3347;Escurial;Cáceres;Extremadura;855;453;402
5361;Escurial de la Sierra;Salamanca;Castilla y León;239;135;104
3450;Escúzar;Granada;Andalucía;791;408;383
2979;Esgos;Ourense;Galicia;1116;577;539
5143;Esguevillas de Esgueva;Valladolid;Castilla y León;271;146;125
1479;Eskoriatza;Gipuzkoa;País Vasco;4065;2033;2032
6603;Eslava;Navarra;Navarra;111;51;60
3513;Eslida;Castellón/Castelló;Comunidad Valenciana;759;383;376
7888;Espadaña;Salamanca;Castilla y León;31;19;12
6670;Espadañedo;Zamora;Castilla y León;107;53;54
7213;Espadilla;Castellón/Castelló;Comunidad Valenciana;71;42;29
2630;Esparragalejo;Badajoz;Extremadura;1462;722;740
3102;Esparragosa de la Serena;Badajoz;Extremadura;1019;517;502
3259;Esparragosa de Lares;Badajoz;Extremadura;925;451;474
359;Esparreguera;Barcelona;Cataluña;22251;11249;11002
517;Espartinas;Sevilla;Andalucía;15791;7898;7893
7175;Esparza de Salazar/Espartza Zaraitzu;Navarra;Navarra;74;40;34
5483;Espeja;Salamanca;Castilla y León;222;114;108
6092;Espeja de San Marcelino;Soria;Castilla y León;155;91;64
1667;Espejo;Córdoba;Andalucía;3329;1671;1658
6013;Espejón;Soria;Castilla y León;161;86;75
3823;Espeluy;Jaén;Andalucía;619;304;315
1520;Espera;Cádiz;Andalucía;3860;1939;1921
2030;Espiel;Córdoba;Andalucía;2397;1207;1190
832;Espinar, El;Segovia;Castilla y León;8986;4557;4429
5533;Espinelves;Girona;Cataluña;215;110;105
5199;Espino de la Orbada;Salamanca;Castilla y León;262;145;117
6215;Espinosa de Cerrato;Palencia;Castilla y León;144;77;67
6782;Espinosa de Cervera;Burgos;Castilla y León;100;63;37
3800;Espinosa de Henares;Guadalajara;Castilla-La Mancha;628;325;303
6542;Espinosa de los Caballeros;Ávila;Castilla y León;114;62;52
2454;Espinosa de los Monteros;Burgos;Castilla y León;1681;877;804
5897;Espinosa de Villagonzalo;Palencia;Castilla y León;172;91;81
7652;Espinosa del Camino;Burgos;Castilla y León;45;27;18
4367;Espinoso del Rey;Toledo;Castilla-La Mancha;436;247;189
2723;Espirdo;Segovia;Castilla y León;1344;706;638
7765;Esplegares;Guadalajara;Castilla-La Mancha;38;23;15
4751;Espluga Calba, L';Lleida;Cataluña;341;171;170
1547;Espluga de Francolí, L';Tarragona;Cataluña;3755;1824;1931
155;Esplugues de Llobregat;Barcelona;Cataluña;46680;22300;24380
3924;Esplús;Huesca;Aragón;581;290;291
4433;Espolla;Girona;Cataluña;416;203;213
4357;Esponellà;Girona;Cataluña;438;224;214
1289;Esporles;Balears, Illes;Islas Baleares;5062;2503;2559
4645;Espot;Lleida;Cataluña;364;193;171
6720;Espronceda;Navarra;Navarra;104;58;46
5252;Espunyola, L';Barcelona;Cataluña;254;126;128
2146;Esquirol, L';Barcelona;Cataluña;2181;1105;1076
1194;Esquivias;Toledo;Castilla-La Mancha;5549;2822;2727
7787;Establés;Guadalajara;Castilla-La Mancha;37;24;13
5588;Estada;Huesca;Aragón;208;122;86
3438;Estadilla;Huesca;Aragón;800;385;415
6494;Estamariu;Lleida;Cataluña;118;68;50
4475;Estany, L';Barcelona;Cataluña;406;205;201
5998;Estaràs;Lleida;Cataluña;162;85;77
575;Estella-Lizarra;Navarra;Navarra;13810;6608;7202
4888;Estellencs;Balears, Illes;Islas Baleares;315;174;141
620;Estepa;Sevilla;Andalucía;12505;6229;6276
8129;Estepa de San Juan;Soria;Castilla y León;7;6;1
3897;Estépar;Burgos;Castilla y León;589;355;234
110;Estepona;Málaga;Andalucía;68286;33508;34778
5620;Estercuel;Teruel;Aragón;203;111;92
1892;Esteribar;Navarra;Navarra;2702;1396;1306
3484;Esterri d'Àneu;Lleida;Cataluña;772;364;408
7225;Esterri de Cardós;Lleida;Cataluña;70;37;33
2633;Estivella;Valencia/València;Comunidad Valenciana;1456;703;753
7004;Estollo;Rioja, La;La Rioja;85;56;29
6469;Estopiñán del Castillo;Huesca;Aragón;120;65;55
395;Estrada, A;Pontevedra;Galicia;20479;9811;10668
5459;Estrella, La;Toledo;Castilla-La Mancha;225;117;108
2800;Estremera;Madrid;Comunidad de Madrid;1260;637;623
8098;Estriégana;Guadalajara;Castilla-La Mancha;14;9;5
6463;Estubeny;Valencia/València;Comunidad Valenciana;121;61;60
7416;Etayo;Navarra;Navarra;58;31;27
3422;Etxalar;Navarra;Navarra;813;427;386
1992;Etxarri Aranatz;Navarra;Navarra;2483;1290;1193
3744;Etxauri;Navarra;Navarra;650;331;319
665;Etxebarri;Bizkaia;País Vasco;11563;5792;5771
3457;Etxebarria;Bizkaia;País Vasco;788;394;394
5060;Eulate;Navarra;Navarra;284;158;126
2371;Ezcabarte;Navarra;Navarra;1805;944;861
2237;Ezcaray;Rioja, La;La Rioja;2024;1051;973
4941;Ezcároz/Ezkaroze;Navarra;Navarra;306;166;140
3843;Ezkio-Itsaso;Gipuzkoa;País Vasco;611;321;290
6195;Ezkurra;Navarra;Navarra;146;95;51
7688;Ezprogui;Navarra;Navarra;43;23;20
2967;Fabara;Zaragoza;Aragón;1125;612;513
1387;Fabero;León;Castilla y León;4493;2194;2299
6674;Facheca;Alicante/Alacant;Comunidad Valenciana;106;52;54
8018;Fago;Huesca;Aragón;22;12;10
2069;Falces;Navarra;Navarra;2315;1185;1130
1841;Falset;Tarragona;Cataluña;2834;1412;1422
7624;Famorca;Alicante/Alacant;Comunidad Valenciana;47;24;23
6772;Fanlo;Huesca;Aragón;101;63;38
5162;Fanzara;Castellón/Castelló;Comunidad Valenciana;267;137;130
3875;Far d'Empordà, El;Girona;Cataluña;599;305;294
5267;Faraján;Málaga;Andalucía;253;124;129
4809;Faramontanos de Tábara;Zamora;Castilla y León;330;173;157
4120;Fariza;Zamora;Castilla y León;506;264;242
4579;Farlete;Zaragoza;Aragón;379;183;196
6523;Farrera;Lleida;Cataluña;116;65;51
1859;Fasnia;Santa Cruz de Tenerife;Canarias;2786;1458;1328
3234;Fatarella, La;Tarragona;Cataluña;941;458;483
1607;Faura;Valencia/València;Comunidad Valenciana;3538;1791;1747
1976;Favara;Valencia/València;Comunidad Valenciana;2518;1286;1232
4580;Fayón;Zaragoza;Aragón;379;197;182
6286;Fayos, Los;Zaragoza;Aragón;139;74;65
7745;Febró, La;Tarragona;Cataluña;40;25;15
464;Felanitx;Balears, Illes;Islas Baleares;17780;8956;8824
3799;Felix;Almería;Andalucía;628;357;271
608;Fene;Coruña, A;Galicia;12944;6170;6774
3759;Férez;Albacete;Castilla-La Mancha;643;317;326
2942;Feria;Badajoz;Extremadura;1144;559;585
2860;Fermoselle;Zamora;Castilla y León;1206;608;598
3130;Fernán Caballero;Ciudad Real;Castilla-La Mancha;1001;506;495
777;Fernán-Núñez;Córdoba;Andalucía;9663;4840;4823
4974;Ferreira;Granada;Andalucía;299;157;142
4143;Ferreras de Abajo;Zamora;Castilla y León;499;252;247
4643;Ferreras de Arriba;Zamora;Castilla y León;365;203;162
1336;Ferreries;Balears, Illes;Islas Baleares;4777;2384;2393
4251;Ferreruela;Zamora;Castilla y León;466;257;209
7478;Ferreruela de Huerva;Teruel;Aragón;56;33;23
116;Ferrol;Coruña, A;Galicia;66065;31027;35038
2982;Figaró-Montmany;Barcelona;Cataluña;1114;547;567
7701;Fígols;Barcelona;Cataluña;42;25;17
5277;Fígols i Alinyà;Lleida;Cataluña;252;145;107
6607;Figuera, La;Tarragona;Cataluña;111;63;48
156;Figueres;Girona;Cataluña;46654;23092;23562
4859;Figuerola del Camp;Tarragona;Cataluña;320;159;161
4071;Figueroles;Castellón/Castelló;Comunidad Valenciana;523;261;262
4799;Figueruela de Arriba;Zamora;Castilla y León;332;157;175
2802;Figueruelas;Zaragoza;Aragón;1259;629;630
2194;Fines;Almería;Andalucía;2079;1093;986
1040;Finestrat;Alicante/Alacant;Comunidad Valenciana;6715;3440;3275
2258;Fiñana;Almería;Andalucía;1994;1002;992
960;Firgas;Palmas, Las;Canarias;7455;3755;3700
4805;Fiscal;Huesca;Aragón;330;182;148
1348;Fisterra;Coruña, A;Galicia;4708;2380;2328
2251;Fitero;Navarra;Navarra;2011;1005;1006
3009;Flaçà;Girona;Cataluña;1093;528;565
1645;Flix;Tarragona;Cataluña;3408;1717;1691
4939;Flores de Ávila;Ávila;Castilla y León;306;168;138
6183;Floresta, La;Lleida;Cataluña;147;79;68
5149;Florida de Liébana;Salamanca;Castilla y León;270;144;126
2637;Fogars de la Selva;Barcelona;Cataluña;1451;748;703
4235;Fogars de Montclús;Barcelona;Cataluña;470;245;225
975;Foios;Valencia/València;Comunidad Valenciana;7367;3632;3735
4985;Foixà;Girona;Cataluña;297;150;147
3021;Folgoso de la Ribera;León;Castilla y León;1080;524;556
3095;Folgoso do Courel;Lugo;Galicia;1024;530;494
2100;Folgueroles;Barcelona;Cataluña;2267;1159;1108
5891;Fombellida;Valladolid;Castilla y León;173;100;73
7483;Fombuena;Zaragoza;Aragón;56;36;20
6807;Fompedraza;Valladolid;Castilla y León;99;51;48
6890;Foncea;Rioja, La;La Rioja;93;54;39
3466;Fondarella;Lleida;Cataluña;784;387;397
1957;Fondó de les Neus, el/Hondón de las Nieves;Alicante/Alacant;Comunidad Valenciana;2544;1306;1238
3149;Fondón;Almería;Andalucía;989;514;475
3162;Fonelas;Granada;Andalucía;978;505;473
3522;Fonfría;Zamora;Castilla y León;756;397;359
7964;Fonfría;Teruel;Aragón;27;15;12
2634;Fonollosa;Barcelona;Cataluña;1453;750;703
1631;Fonsagrada, A;Lugo;Galicia;3465;1816;1649
1538;Font d'En Carròs, la;Valencia/València;Comunidad Valenciana;3794;1889;1905
2223;Font de la Figuera, la;Valencia/València;Comunidad Valenciana;2038;1020;1018
2736;Font-rubí;Barcelona;Cataluña;1327;688;639
4332;Fontanals de Cerdanya;Girona;Cataluña;444;220;224
2042;Fontanar;Guadalajara;Castilla-La Mancha;2370;1237;1133
5116;Fontanarejo;Ciudad Real;Castilla-La Mancha;275;152;123
3178;Fontanars dels Alforins;Valencia/València;Comunidad Valenciana;971;500;471
6281;Fontanilles;Girona;Cataluña;139;80;59
2621;Fontcoberta;Girona;Cataluña;1468;738;730
3139;Fontellas;Navarra;Navarra;996;501;495
7777;Fontihoyuelo;Valladolid;Castilla y León;38;22;16
7503;Fontioso;Burgos;Castilla y León;54;33;21
3532;Fontiveros;Ávila;Castilla y León;748;387;361
3342;Fonz;Huesca;Aragón;859;434;425
6315;Fonzaleche;Rioja, La;La Rioja;135;85;50
5760;Foradada;Lleida;Cataluña;186;108;78
5895;Foradada del Toscar;Huesca;Aragón;172;91;81
2447;Forallac;Girona;Cataluña;1687;828;859
4253;Forcall;Castellón/Castelló;Comunidad Valenciana;465;230;235
1652;Forcarei;Pontevedra;Galicia;3388;1617;1771
7694;Forès;Tarragona;Cataluña;43;25;18
5698;Forfoleda;Salamanca;Castilla y León;193;108;85
642;Formentera;Balears, Illes;Islas Baleares;12111;6365;5746
1448;Formentera del Segura;Alicante/Alacant;Comunidad Valenciana;4191;2105;2086
6259;Formiche Alto;Teruel;Aragón;141;80;61
3724;Fornalutx;Balears, Illes;Islas Baleares;660;330;330
1910;Fornells de la Selva;Girona;Cataluña;2650;1322;1328
2496;Fornelos de Montes;Pontevedra;Galicia;1616;770;846
3987;Fornes;Granada;Andalucía;555;280;275
7075;Fórnoles;Teruel;Aragón;80;43;37
3090;Fortaleny;Valencia/València;Comunidad Valenciana;1026;508;518
5611;Fortanete;Teruel;Aragón;205;119;86
3503;Fortià;Girona;Cataluña;763;389;374
749;Fortuna;Murcia;Región de Murcia;10112;5412;4700
3267;Forua;Bizkaia;País Vasco;920;449;471
756;Foz;Lugo;Galicia;9980;4863;5117
5329;Foz-Calanda;Teruel;Aragón;245;128;117
2058;Frades;Coruña, A;Galicia;2339;1162;1177
5797;Frades de la Sierra;Salamanca;Castilla y León;183;104;79
541;Fraga;Huesca;Aragón;15033;7643;7390
6810;Frago, El;Zaragoza;Aragón;99;61;38
2530;Frailes;Jaén;Andalucía;1575;783;792
1537;Franco, El;Asturias;Principado de Asturias;3796;1865;1931
6870;Frandovínez;Burgos;Castilla y León;94;54;40
411;Franqueses del Vallès, Les;Barcelona;Cataluña;20092;10210;9882
4575;Frasno, El;Zaragoza;Aragón;380;216;164
6184;Frechilla;Palencia;Castilla y León;147;71;76
7998;Frechilla de Almazán;Soria;Castilla y León;24;13;11
1326;Fregenal de la Sierra;Badajoz;Extremadura;4847;2377;2470
4717;Fregeneda, La;Salamanca;Castilla y León;348;171;177
4729;Freginals;Tarragona;Cataluña;346;175;171
3274;Freila;Granada;Andalucía;918;472;446
5616;Fréscano;Zaragoza;Aragón;204;113;91
7730;Fresneda de Altarejos;Cuenca;Castilla-La Mancha;40;20;20
5964;Fresneda de Cuéllar;Segovia;Castilla y León;165;92;73
7612;Fresneda de la Sierra;Cuenca;Castilla-La Mancha;48;28;20
6858;Fresneda de la Sierra Tirón;Burgos;Castilla y León;95;61;34
4359;Fresneda, La;Teruel;Aragón;438;245;193
6518;Fresnedilla;Ávila;Castilla y León;116;58;58
2532;Fresnedillas de la Oliva;Madrid;Comunidad de Madrid;1572;797;775
6686;Fresnedoso;Salamanca;Castilla y León;106;61;45
5156;Fresnedoso de Ibor;Cáceres;Extremadura;268;145;123
7248;Fresneña;Burgos;Castilla y León;68;45;23
3725;Fresnillo de las Dueñas;Burgos;Castilla y León;660;340;320
5555;Fresno Alhándiga;Salamanca;Castilla y León;213;116;97
5178;Fresno de Cantespino;Segovia;Castilla y León;265;148;117
8042;Fresno de Caracena;Soria;Castilla y León;21;14;7
7269;Fresno de la Fuente;Segovia;Castilla y León;67;37;30
6293;Fresno de la Polvorosa;Zamora;Castilla y León;138;76;62
4592;Fresno de la Ribera;Zamora;Castilla y León;377;195;182
4150;Fresno de la Vega;León;Castilla y León;496;256;240
5755;Fresno de Río Tirón;Burgos;Castilla y León;186;113;73
7666;Fresno de Rodilla;Burgos;Castilla y León;44;25;19
5951;Fresno de Sayago;Zamora;Castilla y León;167;86;81
2129;Fresno de Torote;Madrid;Comunidad de Madrid;2221;1164;1057
5729;Fresno del Río;Palencia;Castilla y León;189;93;96
3303;Fresno el Viejo;Valladolid;Castilla y León;885;472;413
3896;Fresno, El;Ávila;Castilla y León;589;310;279
5270;Frías;Burgos;Castilla y León;252;131;121
6541;Frías de Albarracín;Teruel;Aragón;115;69;46
6130;Friera de Valverde;Zamora;Castilla y León;152;83;69
1770;Frigiliana;Málaga;Andalucía;3009;1503;1506
1551;Friol;Lugo;Galicia;3744;1888;1856
3492;Frómista;Palencia;Castilla y León;767;401;366
1477;Frontera;Santa Cruz de Tenerife;Canarias;4093;2050;2043
6084;Frontera, La;Cuenca;Castilla-La Mancha;155;82;73
4028;Fruiz;Bizkaia;País Vasco;536;272;264
6593;Frumales;Segovia;Castilla y León;112;60;52
8112;Fuembellida;Guadalajara;Castilla-La Mancha;10;7;3
3078;Fuencaliente;Ciudad Real;Castilla-La Mancha;1036;538;498
2433;Fuencaliente de la Palma;Santa Cruz de Tenerife;Canarias;1722;857;865
6989;Fuencemillán;Guadalajara;Castilla-La Mancha;86;56;30
3479;Fuendejalón;Zaragoza;Aragón;778;422;356
6210;Fuendetodos;Zaragoza;Aragón;145;80;65
7790;Fuenferrada;Teruel;Aragón;37;22;15
92;Fuengirola;Málaga;Andalucía;80309;39217;41092
32;Fuenlabrada;Madrid;Comunidad de Madrid;193700;95409;98291
2334;Fuenlabrada de los Montes;Badajoz;Extremadura;1845;908;937
5518;Fuenllana;Ciudad Real;Castilla-La Mancha;217;111;106
1724;Fuenmayor;Rioja, La;La Rioja;3134;1585;1549
2388;Fuensaldaña;Valladolid;Castilla y León;1773;909;864
676;Fuensalida;Toledo;Castilla-La Mancha;11370;5768;5602
4983;Fuensanta;Albacete;Castilla-La Mancha;297;168;129
1741;Fuensanta de Martos;Jaén;Andalucía;3074;1539;1535
495;Fuente Álamo de Murcia;Murcia;Región de Murcia;16583;8611;7972
2958;Fuente Carreteros;Córdoba;Andalucía;1131;578;553
1344;Fuente de Cantos;Badajoz;Extremadura;4721;2335;2386
2861;Fuente de Pedro Naharro;Cuenca;Castilla-La Mancha;1205;624;581
1936;Fuente de Piedra;Málaga;Andalucía;2596;1330;1266
2760;Fuente de San Esteban, La;Salamanca;Castilla y León;1299;657;642
6526;Fuente de Santa Cruz;Segovia;Castilla y León;116;63;53
3657;Fuente del Arco;Badajoz;Extremadura;688;353;335
1036;Fuente del Maestre;Badajoz;Extremadura;6743;3349;3394
1706;Fuente el Fresno;Ciudad Real;Castilla-La Mancha;3220;1658;1562
5864;Fuente el Olmo de Fuentidueña;Segovia;Castilla y León;176;78;98
7475;Fuente el Olmo de Íscar;Segovia;Castilla y León;56;31;25
5910;Fuente el Saúz;Ávila;Castilla y León;170;91;79
1042;Fuente el Saz de Jarama;Madrid;Comunidad de Madrid;6696;3379;3317
6079;Fuente el Sol;Valladolid;Castilla y León;156;82;74
6693;Fuente Encalada;Zamora;Castilla y León;106;59;47
4696;Fuente la Lancha;Córdoba;Andalucía;351;182;169
7535;Fuente la Reina;Castellón/Castelló;Comunidad Valenciana;52;28;24
1369;Fuente Obejuna;Córdoba;Andalucía;4604;2374;2230
770;Fuente Palmera;Córdoba;Andalucía;9783;4886;4897
1407;Fuente Vaqueros;Granada;Andalucía;4406;2210;2196
1988;Fuente-Álamo;Albacete;Castilla-La Mancha;2489;1307;1182
7833;Fuente-Olmedo;Valladolid;Castilla y León;34;17;17
3696;Fuente-Tójar;Córdoba;Andalucía;672;325;347
2377;Fuentealbilla;Albacete;Castilla-La Mancha;1792;914;878
5844;Fuentearmegil;Soria;Castilla y León;178;102;76
7653;Fuentebureba;Burgos;Castilla y León;45;25;20
7829;Fuentecambrón;Soria;Castilla y León;34;21;13
7366;Fuentecantos;Soria;Castilla y León;61;31;30
5559;Fuentecén;Burgos;Castilla y León;212;117;95
3685;Fuenteguinaldo;Salamanca;Castilla y León;677;333;344
3684;Fuenteheridos;Huelva;Andalucía;678;338;340
6303;Fuentelahiguera de Albatages;Guadalajara;Castilla-La Mancha;136;77;59
3669;Fuentelapeña;Zamora;Castilla y León;684;359;325
5368;Fuentelcésped;Burgos;Castilla y León;238;121;117
4832;Fuentelencina;Guadalajara;Castilla-La Mancha;325;176;149
5121;Fuentelespino de Haro;Cuenca;Castilla-La Mancha;274;142;132
6637;Fuentelespino de Moya;Cuenca;Castilla-La Mancha;109;60;49
6775;Fuenteliante;Salamanca;Castilla y León;101;51;50
6840;Fuentelisendo;Burgos;Castilla y León;96;51;45
7367;Fuentelmonge;Soria;Castilla y León;61;36;25
6873;Fuentelsaz;Guadalajara;Castilla-La Mancha;94;51;43
7287;Fuentelsaz de Soria;Soria;Castilla y León;66;33;33
7641;Fuentelviejo;Guadalajara;Castilla-La Mancha;46;25;21
6783;Fuentemolinos;Burgos;Castilla y León;100;67;33
4101;Fuentenava de Jábaga;Cuenca;Castilla-La Mancha;513;268;245
6476;Fuentenebro;Burgos;Castilla y León;119;73;46
4090;Fuentenovilla;Guadalajara;Castilla-La Mancha;517;286;231
3376;Fuentepelayo;Segovia;Castilla y León;836;442;394
6969;Fuentepinilla;Soria;Castilla y León;88;57;31
6847;Fuentepiñel;Segovia;Castilla y León;96;53;43
4752;Fuenterrebollo;Segovia;Castilla y León;341;177;164
5159;Fuenterroble de Salvatierra;Salamanca;Castilla y León;268;139;129
3675;Fuenterrobles;Valencia/València;Comunidad Valenciana;682;379;303
4285;Fuentes;Cuenca;Castilla-La Mancha;455;241;214
6907;Fuentes Calientes;Teruel;Aragón;92;53;39
4267;Fuentes Claras;Teruel;Aragón;461;252;209
1000;Fuentes de Andalucía;Sevilla;Andalucía;7111;3546;3565
6780;Fuentes de Año;Ávila;Castilla y León;100;58;42
6975;Fuentes de Ayódar;Castellón/Castelló;Comunidad Valenciana;87;50;37
5525;Fuentes de Béjar;Salamanca;Castilla y León;216;106;110
6814;Fuentes de Carbajal;León;Castilla y León;98;53;45
1382;Fuentes de Ebro;Zaragoza;Aragón;4504;2325;2179
5418;Fuentes de Jiloca;Zaragoza;Aragón;231;122;109
2077;Fuentes de León;Badajoz;Extremadura;2302;1136;1166
7320;Fuentes de Magaña;Soria;Castilla y León;64;38;26
3774;Fuentes de Nava;Palencia;Castilla y León;637;322;315
2954;Fuentes de Oñoro;Salamanca;Castilla y León;1134;601;533
4601;Fuentes de Ropel;Zamora;Castilla y León;374;192;182
6498;Fuentes de Rubielos;Teruel;Aragón;118;61;57
4304;Fuentes de Valdepero;Palencia;Castilla y León;451;237;214
2614;Fuentesaúco;Zamora;Castilla y León;1475;733;742
5352;Fuentesaúco de Fuentidueña;Segovia;Castilla y León;240;123;117
7591;Fuentesecas;Zamora;Castilla y León;50;25;25
6653;Fuentesoto;Segovia;Castilla y León;108;59;49
5062;Fuentespalda;Teruel;Aragón;284;143;141
3517;Fuentespina;Burgos;Castilla y León;757;391;366
5056;Fuentespreadas;Zamora;Castilla y León;286;153;133
7692;Fuentestrún;Soria;Castilla y León;43;29;14
6186;Fuentidueña;Segovia;Castilla y León;147;86;61
2214;Fuentidueña de Tajo;Madrid;Comunidad de Madrid;2053;1023;1030
2706;Fuerte del Rey;Jaén;Andalucía;1357;688;669
7329;Fuertescusa;Cuenca;Castilla-La Mancha;63;35;28
3906;Fueva, La;Huesca;Aragón;587;312;275
2818;Fuliola, La;Lleida;Cataluña;1248;619;629
7003;Fulleda;Lleida;Cataluña;85;44;41
2003;Funes;Navarra;Navarra;2440;1285;1155
1987;Fustiñana;Navarra;Navarra;2490;1236;1254
5791;Gabaldón;Cuenca;Castilla-La Mancha;183;111;72
379;Gabias, Las;Granada;Andalucía;21115;10738;10377
4177;Gabiria;Gipuzkoa;País Vasco;488;258;230
1767;Gádor;Almería;Andalucía;3012;1569;1443
5869;Gaià;Barcelona;Cataluña;175;97;78
4295;Gaianes;Alicante/Alacant;Comunidad Valenciana;452;227;225
5734;Gaibiel;Castellón/Castelló;Comunidad Valenciana;188;102;86
6378;Gaintza;Gipuzkoa;País Vasco;128;75;53
7626;Gajanejos;Guadalajara;Castilla-La Mancha;47;32;15
5979;Gajates;Salamanca;Castilla y León;163;75;88
221;Galapagar;Madrid;Comunidad de Madrid;33742;16470;17272
2028;Galápagos;Guadalajara;Castilla-La Mancha;2403;1264;1139
2095;Galar;Navarra;Navarra;2273;1193;1080
2682;Galaroza;Huelva;Andalucía;1379;681;698
7917;Galbarros;Burgos;Castilla y León;29;18;11
7344;Galbárruli;Rioja, La;La Rioja;62;42;20
260;Galdakao;Bizkaia;País Vasco;29326;14454;14872
3386;Galdames;Bizkaia;País Vasco;831;442;389
329;Gáldar;Palmas, Las;Canarias;24242;12099;12143
3125;Galende;Zamora;Castilla y León;1004;507;497
3031;Galera;Granada;Andalucía;1075;541;534
3575;Galera, La;Tarragona;Cataluña;731;375;356
4699;Galilea;Rioja, La;La Rioja;351;177;174
3668;Galindo y Perahuy;Salamanca;Castilla y León;684;397;287
4405;Galinduste;Salamanca;Castilla y León;427;209;218
4583;Galisancho;Salamanca;Castilla y León;378;203;175
3273;Galisteo;Cáceres;Extremadura;918;457;461
1855;Gallardos, Los;Almería;Andalucía;2794;1408;1386
7654;Gallega, La;Burgos;Castilla y León;45;29;16
6723;Gallegos;Segovia;Castilla y León;104;57;47
7220;Gallegos de Altamiros;Ávila;Castilla y León;70;39;31
5070;Gallegos de Argañán;Salamanca;Castilla y León;283;139;144
6448;Gallegos de Hornija;Valladolid;Castilla y León;122;63;59
7699;Gallegos de Sobrinos;Ávila;Castilla y León;42;21;21
6624;Gallegos de Solmirón;Salamanca;Castilla y León;110;63;47
6573;Gallegos del Pan;Zamora;Castilla y León;113;66;47
4173;Gallegos del Río;Zamora;Castilla y León;490;272;218
5893;Gallifa;Barcelona;Cataluña;172;95;77
8022;Gallinero de Cameros;Rioja, La;La Rioja;22;15;7
6815;Gallipienzo/Galipentzu;Navarra;Navarra;98;55;43
6132;Gallocanta;Zaragoza;Aragón;152;87;65
6889;Gallués/Galoze;Navarra;Navarra;93;63;30
1937;Gallur;Zaragoza;Aragón;2596;1301;1295
6004;Galve;Teruel;Aragón;162;84;78
6787;Galve de Sorbe;Guadalajara;Castilla-La Mancha;100;55;45
1765;Gálvez;Toledo;Castilla-La Mancha;3016;1501;1515
2681;Gamiz-Fika;Bizkaia;País Vasco;1379;678;701
6896;Gamones;Zamora;Castilla y León;93;55;38
1746;Gandesa;Tarragona;Cataluña;3064;1563;1501
102;Gandia;Valencia/València;Comunidad Valenciana;74562;36665;37897
7388;Garaballa;Cuenca;Castilla-La Mancha;59;33;26
1320;Garachico;Santa Cruz de Tenerife;Canarias;4871;2442;2429
2465;Garafía;Santa Cruz de Tenerife;Canarias;1667;881;786
4818;Garai;Bizkaia;País Vasco;327;163;164
6921;Garaioa;Navarra;Navarra;91;51;40
4110;Garbayuela;Badajoz;Extremadura;508;267;241
4059;Garcia;Tarragona;Cataluña;527;264;263
3617;Garciaz;Cáceres;Extremadura;709;365;344
5798;Garcibuey;Salamanca;Castilla y León;183;108;75
4311;Garcihernández;Salamanca;Castilla y León;449;236;213
4260;Garcillán;Segovia;Castilla y León;463;244;219
5607;Garciotum;Toledo;Castilla-La Mancha;206;108;98
7364;Garcirrey;Salamanca;Castilla y León;61;36;25
6282;Garde;Navarra;Navarra;139;83;56
6895;Gargallo;Teruel;Aragón;93;51;42
4723;Garganta de los Montes;Madrid;Comunidad de Madrid;347;189;158
7747;Garganta del Villar;Ávila;Castilla y León;39;27;12
3206;Garganta la Olla;Cáceres;Extremadura;957;504;453
4581;Garganta, La;Cáceres;Extremadura;378;208;170
4532;Gargantilla;Cáceres;Extremadura;389;204;185
4885;Gargantilla del Lozoya y Pinilla de Buitrago;Madrid;Comunidad de Madrid;316;170;146
6386;Gargüera;Cáceres;Extremadura;127;72;55
5750;Garidells, Els;Tarragona;Cataluña;187;94;93
4140;Garínoain;Navarra;Navarra;499;263;236
3905;Garlitos;Badajoz;Extremadura;587;305;282
2584;Garrafe de Torío;León;Castilla y León;1504;811;693
5718;Garralda;Navarra;Navarra;190;100;90
3573;Garray;Soria;Castilla y León;732;395;337
497;Garriga, La;Barcelona;Cataluña;16514;7987;8527
4362;Garrigàs;Girona;Cataluña;437;231;206
5994;Garrigoles;Girona;Cataluña;162;84;78
3348;Garriguella;Girona;Cataluña;855;421;434
3454;Garrobo, El;Sevilla;Andalucía;790;400;390
2053;Garrovilla, La;Badajoz;Extremadura;2346;1166;1180
2225;Garrovillas de Alconétar;Cáceres;Extremadura;2034;1005;1029
809;Garrucha;Almería;Andalucía;9212;4763;4449
6861;Garvín;Cáceres;Extremadura;95;52;43
5696;Gascones;Madrid;Comunidad de Madrid;193;110;83
6109;Gascueña;Cuenca;Castilla-La Mancha;153;86;67
7940;Gascueña de Bornova;Guadalajara;Castilla-La Mancha;28;16;12
2409;Gastor, El;Cádiz;Andalucía;1752;905;847
2640;Gata;Cáceres;Extremadura;1447;751;696
1121;Gata de Gorgos;Alicante/Alacant;Comunidad Valenciana;6049;3082;2967
2470;Gatika;Bizkaia;País Vasco;1663;837;826
7858;Gatón de Campos;Valladolid;Castilla y León;33;17;16
4585;Gátova;Valencia/València;Comunidad Valenciana;378;180;198
2528;Gaucín;Málaga;Andalucía;1576;820;756
3374;Gautegiz Arteaga;Bizkaia;País Vasco;836;421;415
154;Gavà;Barcelona;Cataluña;46771;22876;23895
3076;Gavarda;Valencia/València;Comunidad Valenciana;1038;498;540
5205;Gavet de la Conca;Lleida;Cataluña;261;129;132
3908;Gavilanes;Ávila;Castilla y León;586;312;274
6122;Gaztelu;Gipuzkoa;País Vasco;152;82;70
4665;Gea de Albarracín;Teruel;Aragón;360;194;166
7772;Gejuelo del Barro;Salamanca;Castilla y León;38;22;16
3779;Geldo;Castellón/Castelló;Comunidad Valenciana;635;316;319
949;Gelida;Barcelona;Cataluña;7533;3778;3755
3115;Gelsa;Zaragoza;Aragón;1013;535;478
744;Gelves;Sevilla;Andalucía;10184;5082;5102
5522;Gema;Zamora;Castilla y León;217;107;110
6071;Gemuño;Ávila;Castilla y León;156;81;75
4456;Genalguacil;Málaga;Andalucía;410;205;205
3845;Génave;Jaén;Andalucía;611;335;276
7226;Genevilla;Navarra;Navarra;70;43;27
1835;Genovés, el;Valencia/València;Comunidad Valenciana;2842;1428;1414
4318;Ger;Girona;Cataluña;448;222;226
944;Gerena;Sevilla;Andalucía;7585;3808;3777
3088;Gérgal;Almería;Andalucía;1030;543;487
4108;Geria;Valladolid;Castilla y León;509;242;267
2078;Gerindote;Toledo;Castilla-La Mancha;2300;1170;1130
484;Gernika-Lumo;Bizkaia;País Vasco;17016;8171;8845
3985;Gestalgar;Valencia/València;Comunidad Valenciana;556;295;261
35;Getafe;Madrid;Comunidad de Madrid;183374;89701;93673
1845;Getaria;Gipuzkoa;País Vasco;2821;1430;1391
95;Getxo;Bizkaia;País Vasco;77946;36461;41485
617;Gibraleón;Huelva;Andalucía;12607;6274;6333
15;Gijón;Asturias;Principado de Asturias;271780;128128;143652
7809;Gil García;Ávila;Castilla y León;35;17;18
7311;Gilbuena;Ávila;Castilla y León;64;37;27
1556;Gilena;Sevilla;Andalucía;3727;1866;1861
1670;Gilet;Valencia/València;Comunidad Valenciana;3324;1719;1605
2986;Gimenells i el Pla de la Font;Lleida;Cataluña;1111;595;516
7145;Gimialcón;Ávila;Castilla y León;75;47;28
6584;Gimileo;Rioja, La;La Rioja;112;61;51
5692;Ginebrosa, La;Teruel;Aragón;194;106;88
588;Gines;Sevilla;Andalucía;13420;6605;6815
3528;Ginestar;Tarragona;Cataluña;753;403;350
1977;Gineta, La;Albacete;Castilla-La Mancha;2512;1304;1208
62;Girona;Girona;Cataluña;101852;48931;52921
1331;Gironella;Barcelona;Cataluña;4826;2384;2442
7974;Gisclareny;Barcelona;Cataluña;25;15;10
6244;Gistaín;Huesca;Aragón;142;75;67
5587;Gizaburuaga;Bizkaia;País Vasco;208;105;103
5397;Gobernador;Granada;Andalucía;233;116;117
3938;Godall;Tarragona;Cataluña;575;289;286
600;Godella;Valencia/València;Comunidad Valenciana;13088;6317;6771
1609;Godelleta;Valencia/València;Comunidad Valenciana;3533;1819;1714
7517;Godojos;Zaragoza;Aragón;54;30;24
3627;Goizueta;Navarra;Navarra;704;379;325
1159;Gójar;Granada;Andalucía;5795;2947;2848
1924;Golmayo;Soria;Castilla y León;2626;1369;1257
2338;Golmés;Lleida;Cataluña;1840;917;923
6713;Golosalvo;Albacete;Castilla-La Mancha;104;55;49
6142;Golpejas;Salamanca;Castilla y León;151;74;77
4927;Gómara;Soria;Castilla y León;310;169;141
5736;Gombrèn;Girona;Cataluña;188;96;92
4342;Gomecello;Salamanca;Castilla y León;442;235;207
3572;Gomesende;Ourense;Galicia;732;356;376
3671;Gomezserracín;Segovia;Castilla y León;683;359;324
561;Gondomar;Pontevedra;Galicia;14286;7091;7195
6047;Goñi;Navarra;Navarra;158;103;55
3568;Gor;Granada;Andalucía;733;382;351
4565;Gorafe;Granada;Andalucía;381;195;186
5276;Gordaliza del Pino;León;Castilla y León;252;124;128
2438;Gordexola;Bizkaia;País Vasco;1710;875;835
4632;Gordo, El;Cáceres;Extremadura;367;193;174
4465;Gordoncillo;León;Castilla y León;409;209;200
5293;Gorga;Alicante/Alacant;Comunidad Valenciana;249;140;109
1160;Gorliz;Bizkaia;País Vasco;5785;2849;2936
8087;Gormaz;Soria;Castilla y León;16;12;4
5603;Gósol;Lleida;Cataluña;206;118;88
5988;Gotarrendura;Ávila;Castilla y León;162;56;106
4875;Gotor;Zaragoza;Aragón;318;165;153
736;Gozón;Asturias;Principado de Asturias;10333;5047;5286
3210;Gradefes;León;Castilla y León;954;521;433
769;Grado;Asturias;Principado de Asturias;9784;4746;5038
4502;Grado, El;Huesca;Aragón;400;210;190
6914;Graja de Campalbo;Cuenca;Castilla-La Mancha;91;50;41
4659;Graja de Iniesta;Cuenca;Castilla-La Mancha;361;185;176
5447;Grajal de Campos;León;Castilla y León;227;113;114
5371;Grajera;Segovia;Castilla y León;238;137;101
20;Granada;Granada;Andalucía;232462;107555;124907
5358;Granada de Río-Tinto, La;Huelva;Andalucía;239;124;115
2156;Granada, La;Barcelona;Cataluña;2157;1092;1065
3611;Granadella, La;Lleida;Cataluña;712;387;325
148;Granadilla de Abona;Santa Cruz de Tenerife;Canarias;50146;25076;25070
4094;Granado, El;Huelva;Andalucía;516;274;242
3607;Granátula de Calatrava;Ciudad Real;Castilla-La Mancha;714;346;368
3377;Grandas de Salime;Asturias;Principado de Asturias;835;426;409
7952;Grandes y San Martín;Ávila;Castilla y León;27;13;14
7234;Granera;Barcelona;Cataluña;69;53;16
3241;Granja d'Escarp, La;Lleida;Cataluña;936;514;422
5059;Granja de la Costera, la;Valencia/València;Comunidad Valenciana;285;142;143
5108;Granja de Moreruela;Zamora;Castilla y León;277;142;135
1946;Granja de Rocamora;Alicante/Alacant;Comunidad Valenciana;2580;1362;1218
2246;Granja de Torrehermosa;Badajoz;Extremadura;2014;1001;1013
4815;Granja, La;Cáceres;Extremadura;328;168;160
4264;Granjuela, La;Córdoba;Andalucía;461;236;225
124;Granollers;Barcelona;Cataluña;61275;30199;31076
6450;Granucillo;Zamora;Castilla y León;122;60;62
6174;Granyanella;Lleida;Cataluña;148;82;66
6346;Granyena de les Garrigues;Lleida;Cataluña;132;78;54
6245;Granyena de Segarra;Lleida;Cataluña;142;76;66
2398;Grañén;Huesca;Aragón;1762;913;849
5254;Grañón;Rioja, La;La Rioja;254;144;110
5430;Gratallops;Tarragona;Cataluña;229;125;104
1649;Graus;Huesca;Aragón;3395;1666;1729
5774;Grávalos;Rioja, La;La Rioja;185;100;85
2235;Grazalema;Cádiz;Andalucía;2027;1006;1021
6311;Griegos;Teruel;Aragón;136;80;56
6600;Grijalba;Burgos;Castilla y León;111;56;55
2067;Grijota;Palencia;Castilla y León;2319;1214;1105
739;Griñón;Madrid;Comunidad de Madrid;10319;5157;5162
7784;Grisaleña;Burgos;Castilla y León;37;27;10
7179;Grisel;Zaragoza;Aragón;74;43;31
3902;Grisén;Zaragoza;Aragón;589;302;287
717;Grove, O;Pontevedra;Galicia;10650;5252;5398
2294;Guadahortuna;Granada;Andalucía;1935;992;943
78;Guadalajara;Guadalajara;Castilla-La Mancha;85871;41272;44599
5346;Guadalaviar;Teruel;Aragón;241;134;107
1921;Guadalcanal;Sevilla;Andalucía;2627;1316;1311
2524;Guadalcázar;Córdoba;Andalucía;1583;794;789
1102;Guadalix de la Sierra;Madrid;Comunidad de Madrid;6214;3136;3078
3585;Guadalmez;Ciudad Real;Castilla-La Mancha;725;350;375
2320;Guadalupe;Cáceres;Extremadura;1862;926;936
2378;Guadamur;Toledo;Castilla-La Mancha;1792;900;892
511;Guadarrama;Madrid;Comunidad de Madrid;16032;7921;8111
4244;Guadasséquies;Valencia/València;Comunidad Valenciana;468;239;229
1144;Guadassuar;Valencia/València;Comunidad Valenciana;5893;2882;3011
1991;Guadiana del Caudillo;Badajoz;Extremadura;2485;1224;1261
448;Guadix;Granada;Andalucía;18422;9120;9302
6270;Guadramiro;Salamanca;Castilla y León;140;84;56
3052;Guájares, Los;Granada;Andalucía;1057;556;501
2590;Gualba;Barcelona;Cataluña;1500;769;731
1263;Gualchos;Granada;Andalucía;5193;2794;2399
4508;Gualta;Girona;Cataluña;397;229;168
1199;Guancha, La;Santa Cruz de Tenerife;Canarias;5520;2687;2833
757;Guarda, A;Pontevedra;Galicia;9977;4877;5100
4062;Guardamar de la Safor;Valencia/València;Comunidad Valenciana;526;283;243
530;Guardamar del Segura;Alicante/Alacant;Comunidad Valenciana;15348;7492;7856
1299;Guardia de Jaén, La;Jaén;Andalucía;5011;2526;2485
2118;Guardia, La;Toledo;Castilla-La Mancha;2246;1133;1113
3282;Guardiola de Berguedà;Barcelona;Cataluña;908;464;444
1131;Guardo;Palencia;Castilla y León;5995;2980;3015
1015;Guareña;Badajoz;Extremadura;6964;3495;3469
2105;Guaro;Málaga;Andalucía;2260;1137;1123
4823;Guarrate;Zamora;Castilla y León;327;168;159
1880;Guarromán;Jaén;Andalucía;2724;1363;1361
7383;Guaza de Campos;Palencia;Castilla y León;60;37;23
7141;Gúdar;Teruel;Aragón;76;47;29
2809;Gudiña, A;Ourense;Galicia;1254;638;616
1848;Güéjar Sierra;Granada;Andalucía;2820;1516;1304
1037;Güeñes;Bizkaia;País Vasco;6734;3254;3480
7770;Güesa/Gorza;Navarra;Navarra;38;22;16
4384;Guesálaz/Gesalatz;Navarra;Navarra;432;254;178
1938;Güevéjar;Granada;Andalucía;2595;1360;1235
375;Guía de Isora;Santa Cruz de Tenerife;Canarias;21368;10653;10715
5150;Guiamets, Els;Tarragona;Cataluña;270;128;142
2669;Guijarrosa, La;Córdoba;Andalucía;1399;714;685
7138;Guijo de Ávila;Salamanca;Castilla y León;76;42;34
5662;Guijo de Coria;Cáceres;Extremadura;197;105;92
2573;Guijo de Galisteo;Cáceres;Extremadura;1513;769;744
4044;Guijo de Granadilla;Cáceres;Extremadura;530;274;256
4541;Guijo de Santa Bárbara;Cáceres;Extremadura;387;204;183
4681;Guijo, El;Córdoba;Andalucía;355;185;170
1184;Guijuelo;Salamanca;Castilla y León;5633;2821;2812
612;Guillena;Sevilla;Andalucía;12788;6440;6348
4024;Guils de Cerdanya;Girona;Cataluña;537;288;249
407;Güímar;Santa Cruz de Tenerife;Canarias;20190;10010;10180
5177;Guimerà;Lleida;Cataluña;265;140;125
4986;Guingueta d'Àneu, La;Lleida;Cataluña;297;159;138
7106;Guirguillano;Navarra;Navarra;78;43;35
4145;Guisando;Ávila;Castilla y León;497;249;248
997;Guissona;Lleida;Cataluña;7136;3810;3326
1205;Guitiriz;Lugo;Galicia;5484;2730;2754
6326;Guixers;Lleida;Cataluña;134;84;50
3981;Gumiel de Izán;Burgos;Castilla y León;556;314;242
4651;Gumiel de Mercado;Burgos;Castilla y León;363;198;165
1897;Guntín;Lugo;Galicia;2690;1381;1309
1902;Gurb;Barcelona;Cataluña;2681;1386;1295
2051;Guriezo;Cantabria;Cantabria;2354;1218;1136
2624;Gurrea de Gállego;Huesca;Aragón;1467;744;723
6417;Gusendos de los Oteros;León;Castilla y León;124;64;60
7097;Gutierre-Muñoz;Ávila;Castilla y León;78;39;39
2822;Haba, La;Badajoz;Extremadura;1243;626;617
6220;Hacinas;Burgos;Castilla y León;143;86;57
5485;Harana/Valle de Arana;Araba/Álava;País Vasco;221;124;97
1281;Haría;Palmas, Las;Canarias;5123;2641;2482
673;Haro;Rioja, La;La Rioja;11408;5611;5797
7901;Haza;Burgos;Castilla y León;30;19;11
2535;Hazas de Cesto;Cantabria;Cantabria;1569;773;796
3749;Helechosa de los Montes;Badajoz;Extremadura;647;363;284
252;Hellín;Albacete;Castilla-La Mancha;30306;15162;15144
6278;Henarejos;Cuenca;Castilla-La Mancha;139;73;66
6716;Henche;Guadalajara;Castilla-La Mancha;104;57;47
5146;Heras de Ayuso;Guadalajara;Castilla-La Mancha;270;164;106
7704;Herbés;Castellón/Castelló;Comunidad Valenciana;42;24;18
4777;Herce;Rioja, La;La Rioja;336;175;161
878;Herencia;Ciudad Real;Castilla-La Mancha;8390;4277;4113
3464;Herencias, Las;Toledo;Castilla-La Mancha;785;419;366
5051;Herguijuela;Cáceres;Extremadura;286;150;136
7109;Herguijuela de Ciudad Rodrigo;Salamanca;Castilla y León;78;46;32
5291;Herguijuela de la Sierra;Salamanca;Castilla y León;250;139;111
7073;Herguijuela del Campo;Salamanca;Castilla y León;80;41;39
2507;Hermandad de Campoo de Suso;Cantabria;Cantabria;1603;894;709
7072;Hérmedes de Cerrato;Palencia;Castilla y León;80;42;38
2345;Hermigua;Santa Cruz de Tenerife;Canarias;1832;943;889
5444;Hermisende;Zamora;Castilla y León;228;118;110
4316;Hernán-Pérez;Cáceres;Extremadura;448;219;229
399;Hernani;Gipuzkoa;País Vasco;20354;9964;10390
6026;Hernansancho;Ávila;Castilla y León;159;93;66
4956;Hernialde;Gipuzkoa;País Vasco;303;159;144
4442;Herradón de Pinares;Ávila;Castilla y León;413;228;185
6550;Herramélluri;Rioja, La;La Rioja;114;62;52
1071;Herrera;Sevilla;Andalucía;6461;3203;3258
5260;Herrera de Alcántara;Cáceres;Extremadura;253;128;125
4121;Herrera de los Navarros;Zaragoza;Aragón;506;278;228
2275;Herrera de Pisuerga;Palencia;Castilla y León;1966;959;1007
8119;Herrera de Soria;Soria;Castilla y León;9;7;2
6011;Herrera de Valdecañas;Palencia;Castilla y León;161;90;71
1624;Herrera del Duque;Badajoz;Extremadura;3482;1748;1734
4824;Herrera, La;Albacete;Castilla-La Mancha;326;167;159
7903;Herrería;Guadalajara;Castilla-La Mancha;30;15;15
3857;Herrerías;Cantabria;Cantabria;605;341;264
6393;Herreros de Suso;Ávila;Castilla y León;126;69;57
4790;Herreruela;Cáceres;Extremadura;333;171;162
4793;Herreruela de Oropesa;Toledo;Castilla-La Mancha;333;171;162
6449;Herrín de Campos;Valladolid;Castilla y León;122;60;62
3713;Herrumblar, El;Cuenca;Castilla-La Mancha;664;338;326
1495;Hervás;Cáceres;Extremadura;3976;1952;2024
6459;Hervías;Rioja, La;La Rioja;121;62;59
6534;Hiendelaencina;Guadalajara;Castilla-La Mancha;115;68;47
6563;Higuera;Cáceres;Extremadura;113;71;42
3824;Higuera de Calatrava;Jaén;Andalucía;619;332;287
3223;Higuera de la Serena;Badajoz;Extremadura;948;494;454
2768;Higuera de la Sierra;Huelva;Andalucía;1287;666;621
5194;Higuera de las Dueñas;Ávila;Castilla y León;262;148;114
4720;Higuera de Llerena;Badajoz;Extremadura;347;178;169
2282;Higuera de Vargas;Badajoz;Extremadura;1955;982;973
2111;Higuera la Real;Badajoz;Extremadura;2253;1132;1121
7507;Higueras;Castellón/Castelló;Comunidad Valenciana;54;31;23
2923;Higueruela;Albacete;Castilla-La Mancha;1158;602;556
4139;Higueruelas;Valencia/València;Comunidad Valenciana;500;271;229
7064;Hija de Dios, La;Ávila;Castilla y León;80;49;31
2434;Híjar;Teruel;Aragón;1721;866;855
8053;Hijes;Guadalajara;Castilla-La Mancha;19;10;9
4887;Hiniesta, La;Zamora;Castilla y León;316;166;150
4496;Hinojal;Cáceres;Extremadura;401;208;193
4833;Hinojales;Huelva;Andalucía;325;163;162
4497;Hinojares;Jaén;Andalucía;401;215;186
1496;Hinojos;Huelva;Andalucía;3976;1994;1982
3728;Hinojosa de Duero;Salamanca;Castilla y León;659;330;329
6608;Hinojosa de Jarque;Teruel;Aragón;111;63;48
4559;Hinojosa de San Vicente;Toledo;Castilla-La Mancha;383;210;173
7892;Hinojosa del Campo;Soria;Castilla y León;31;20;11
1031;Hinojosa del Duque;Córdoba;Andalucía;6788;3328;3460
4190;Hinojosa del Valle;Badajoz;Extremadura;483;231;252
5735;Hinojosa, La;Cuenca;Castilla-La Mancha;188;96;92
4029;Hinojosas de Calatrava;Ciudad Real;Castilla-La Mancha;536;274;262
3486;Hinojosos, Los;Cuenca;Castilla-La Mancha;771;380;391
6759;Hiriberri/Villanueva de Aezkoa;Navarra;Navarra;102;54;48
7441;Hiruela, La;Madrid;Comunidad de Madrid;57;39;18
5003;Hita;Guadalajara;Castilla-La Mancha;294;162;132
6252;Hito, El;Cuenca;Castilla-La Mancha;141;77;64
3765;Holguera;Cáceres;Extremadura;641;321;320
7846;Hombrados;Guadalajara;Castilla-La Mancha;33;22;11
488;Hondarribia;Gipuzkoa;País Vasco;16828;8370;8458
2867;Hondón de los Frailes;Alicante/Alacant;Comunidad Valenciana;1198;616;582
2538;Honrubia;Cuenca;Castilla-La Mancha;1566;786;780
7421;Honrubia de la Cuesta;Segovia;Castilla y León;58;34;24
4936;Hontalbilla;Segovia;Castilla y León;307;170;137
6260;Hontanar;Toledo;Castilla-La Mancha;141;83;58
2628;Hontanares de Eresma;Segovia;Castilla y León;1464;762;702
7211;Hontanas;Burgos;Castilla y León;71;44;27
5262;Hontanaya;Cuenca;Castilla-La Mancha;253;143;110
6928;Hontangas;Burgos;Castilla y León;90;60;30
7358;Hontecillas;Cuenca;Castilla-La Mancha;61;33;28
4869;Hontoba;Guadalajara;Castilla-La Mancha;318;180;138
6708;Hontoria de Cerrato;Palencia;Castilla y León;105;54;51
6192;Hontoria de la Cantera;Burgos;Castilla y León;146;76;70
5825;Hontoria de Valdearados;Burgos;Castilla y León;180;107;73
3721;Hontoria del Pinar;Burgos;Castilla y León;661;369;292
4109;Horcajada, La;Ávila;Castilla y León;508;265;243
6207;Horcajo de la Sierra-Aoslos;Madrid;Comunidad de Madrid;145;78;67
4123;Horcajo de las Torres;Ávila;Castilla y León;505;281;224
3308;Horcajo de los Montes;Ciudad Real;Castilla-La Mancha;883;444;439
6288;Horcajo de Montemayor;Salamanca;Castilla y León;138;75;63
1621;Horcajo de Santiago;Cuenca;Castilla-La Mancha;3493;1770;1723
5457;Horcajo Medianero;Salamanca;Castilla y León;225;115;110
6991;Horcajuelo de la Sierra;Madrid;Comunidad de Madrid;86;47;39
1964;Horche;Guadalajara;Castilla-La Mancha;2535;1285;1250
6752;Hormazas, Las;Burgos;Castilla y León;102;58;44
3620;Hormigos;Toledo;Castilla-La Mancha;709;391;318
4434;Hormilla;Rioja, La;La Rioja;416;226;190
6335;Hormilleja;Rioja, La;La Rioja;133;65;68
1590;Hornachos;Badajoz;Extremadura;3595;1807;1788
1385;Hornachuelos;Córdoba;Andalucía;4497;2239;2258
5026;Hornillo, El;Ávila;Castilla y León;290;153;137
8078;Hornillos de Cameros;Rioja, La;La Rioja;17;9;8
6254;Hornillos de Cerrato;Palencia;Castilla y León;141;81;60
5965;Hornillos de Eresma;Valladolid;Castilla y León;165;97;68
7387;Hornillos del Camino;Burgos;Castilla y León;59;32;27
3870;Hornos;Jaén;Andalucía;601;301;300
6818;Hornos de Moncalvillo;Rioja, La;La Rioja;98;58;40
4756;Horra, La;Burgos;Castilla y León;340;184;156
2936;Horta de Sant Joan;Tarragona;Cataluña;1149;602;547
7705;Hortezuela de Océn;Guadalajara;Castilla-La Mancha;42;26;16
6702;Hortigüela;Burgos;Castilla y León;105;71;34
3135;Hospital de Órbigo;León;Castilla y León;998;498;500
16;Hospitalet de Llobregat, L';Barcelona;Cataluña;264923;127981;136942
1788;Hostalets de Pierola, Els;Barcelona;Cataluña;2973;1518;1455
1439;Hostalric;Girona;Cataluña;4221;2130;2091
3748;Hoya-Gonzalo;Albacete;Castilla-La Mancha;647;345;302
7803;Hoya, La;Salamanca;Castilla y León;36;20;16
5396;Hoyales de Roa;Burgos;Castilla y León;233;121;112
873;Hoyo de Manzanares;Madrid;Comunidad de Madrid;8434;4226;4208
2173;Hoyo de Pinares, El;Ávila;Castilla y León;2131;1101;1030
5007;Hoyocasero;Ávila;Castilla y León;293;173;120
7325;Hoyorredondo;Ávila;Castilla y León;63;33;30
3318;Hoyos;Cáceres;Extremadura;874;426;448
7930;Hoyos de Miguel Muñoz;Ávila;Castilla y León;28;15;13
7836;Hoyos del Collado;Ávila;Castilla y León;33;19;14
4554;Hoyos del Espino;Ávila;Castilla y León;383;211;172
7224;Hoz de Jaca;Huesca;Aragón;70;35;35
7036;Hoz de la Vieja, La;Teruel;Aragón;83;42;41
5473;Hoz y Costean;Huesca;Aragón;223;129;94
1002;Huarte/Uharte;Navarra;Navarra;7101;3580;3521
3615;Huecas;Toledo;Castilla-La Mancha;710;369;341
4204;Huécija;Almería;Andalucía;480;233;247
5495;Huélaga;Cáceres;Extremadura;220;109;111
4489;Huélago;Granada;Andalucía;403;208;195
6801;Huélamo;Cuenca;Castilla-La Mancha;99;55;44
1162;Huelma;Jaén;Andalucía;5776;2871;2905
45;Huelva;Huelva;Andalucía;143663;69003;74660
7434;Huelves;Cuenca;Castilla-La Mancha;57;30;27
2885;Huéneja;Granada;Andalucía;1184;667;517
468;Huércal de Almería;Almería;Andalucía;17651;8959;8692
430;Huércal-Overa;Almería;Andalucía;19127;9514;9613
3412;Huércanos;Rioja, La;La Rioja;817;451;366
7559;Huerce, La;Guadalajara;Castilla-La Mancha;51;32;19
7669;Huérguina;Cuenca;Castilla-La Mancha;44;24;20
5766;Huérmeces;Burgos;Castilla y León;185;100;85
7706;Huérmeces del Cerro;Guadalajara;Castilla-La Mancha;42;30;12
5061;Huerta;Salamanca;Castilla y León;284;161;123
6353;Huerta de Arriba;Burgos;Castilla y León;131;77;54
6544;Huerta de la Obispalía;Cuenca;Castilla-La Mancha;114;67;47
3261;Huerta de Rey;Burgos;Castilla y León;923;499;424
2477;Huerta de Valdecarábanos;Toledo;Castilla-La Mancha;1649;817;832
5684;Huerta del Marquesado;Cuenca;Castilla-La Mancha;194;108;86
7523;Huertahernando;Guadalajara;Castilla-La Mancha;53;34;19
5602;Huerto;Huesca;Aragón;206;112;94
5914;Huertos, Los;Segovia;Castilla y León;170;94;76
1990;Huesa;Jaén;Andalucía;2489;1251;1238
7193;Huesa del Común;Teruel;Aragón;73;46;27
137;Huesca;Huesca;Aragón;53132;25352;27780
988;Huéscar;Granada;Andalucía;7253;3586;3667
2391;Huete;Cuenca;Castilla-La Mancha;1765;913;852
2314;Huétor de Santillán;Granada;Andalucía;1877;964;913
731;Huétor Tájar;Granada;Andalucía;10352;5204;5148
646;Huétor Vega;Granada;Andalucía;12039;6043;5996
6224;Hueva;Guadalajara;Castilla-La Mancha;143;89;54
1766;Huévar del Aljarafe;Sevilla;Andalucía;3015;1547;1468
6490;Humada;Burgos;Castilla y León;118;80;38
2594;Humanes;Guadalajara;Castilla-La Mancha;1496;751;745
417;Humanes de Madrid;Madrid;Comunidad de Madrid;19743;9893;9850
1687;Humilladero;Málaga;Andalucía;3286;1630;1656
7297;Hurones;Burgos;Castilla y León;65;44;21
7551;Hurtumpascual;Ávila;Castilla y León;51;32;19
4857;Husillos;Palencia;Castilla y León;320;181;139
4005;Ibahernando;Cáceres;Extremadura;544;272;272
5298;Ibargoiti;Navarra;Navarra;249;148;101
1445;Ibarra;Gipuzkoa;País Vasco;4199;2094;2105
3793;Ibarrangelu;Bizkaia;País Vasco;632;321;311
4488;Ibdes;Zaragoza;Aragón;404;208;196
2667;Ibeas de Juarros;Burgos;Castilla y León;1404;753;651
342;Ibi;Alicante/Alacant;Comunidad Valenciana;23489;11747;11742
2812;Ibias;Asturias;Principado de Asturias;1251;718;533
6843;Ibieca;Huesca;Aragón;96;55;41
7729;Ibrillos;Burgos;Castilla y León;40;26;14
1842;Ibros;Jaén;Andalucía;2832;1422;1410
345;Icod de los Vinos;Santa Cruz de Tenerife;Canarias;23254;11427;11827
2072;Idiazabal;Gipuzkoa;País Vasco;2312;1174;1138
3770;Igantzi;Navarra;Navarra;639;339;300
3881;Igea;Rioja, La;La Rioja;595;341;254
7762;Iglesiarrubia;Burgos;Castilla y León;38;21;17
6203;Iglesias;Burgos;Castilla y León;145;79;66
4458;Iglesuela del Cid, La;Teruel;Aragón;410;216;194
4447;Iglesuela del Tiétar, La;Toledo;Castilla-La Mancha;411;215;196
1425;Igorre;Bizkaia;País Vasco;4284;2107;2177
3591;Igriés;Huesca;Aragón;723;382;341
174;Igualada;Barcelona;Cataluña;39967;19636;20331
3504;Igualeja;Málaga;Andalucía;763;381;382
2941;Igüeña;León;Castilla y León;1145;598;547
4834;Igúzquiza;Navarra;Navarra;325;170;155
4144;Ikaztegieta;Gipuzkoa;País Vasco;498;251;247
5569;Ilche;Huesca;Aragón;211;104;107
1314;Illa de Arousa, A;Pontevedra;Galicia;4926;2458;2468
8131;Illán de Vacas;Toledo;Castilla-La Mancha;3;3;0
3663;Illana;Guadalajara;Castilla-La Mancha;686;377;309
4728;Illano;Asturias;Principado de Asturias;346;173;173
4518;Íllar;Almería;Andalucía;394;211;183
3114;Illas;Asturias;Principado de Asturias;1014;512;502
268;Illescas;Toledo;Castilla-La Mancha;28894;14584;14310
752;Íllora;Granada;Andalucía;10054;5057;4997
1805;Illueca;Zaragoza;Aragón;2924;1451;1473
4414;Imotz;Navarra;Navarra;423;223;200
224;Inca;Balears, Illes;Islas Baleares;33319;16831;16488
2534;Incio, O;Lugo;Galicia;1570;791;779
241;Ingenio;Palmas, Las;Canarias;31321;15769;15552
1421;Iniesta;Cuenca;Castilla-La Mancha;4305;2129;2176
8017;Iniéstola;Guadalajara;Castilla-La Mancha;22;14;8
4314;Instinción;Almería;Andalucía;448;233;215
7393;Inviernas, Las;Guadalajara;Castilla-La Mancha;59;40;19
5896;Irañeta;Navarra;Navarra;172;91;81
2625;Irixo, O;Ourense;Galicia;1466;716;750
2732;Irixoa;Coruña, A;Galicia;1334;663;671
2303;Iruela, La;Jaén;Andalucía;1899;948;951
7850;Iruelos;Salamanca;Castilla y León;33;15;18
7250;Irueste;Guadalajara;Castilla-La Mancha;68;46;22
122;Irun;Gipuzkoa;País Vasco;62401;30494;31907
1643;Iruña Oka/Iruña de Oca;Araba/Álava;País Vasco;3411;1769;1642
2327;Irura;Gipuzkoa;País Vasco;1852;962;890
4089;Iruraiz-Gauna;Araba/Álava;País Vasco;517;281;236
2120;Irurtzun;Navarra;Navarra;2233;1153;1080
4516;Isaba/Izaba;Navarra;Navarra;395;196;199
5382;Isábena;Huesca;Aragón;235;119;116
5002;Isar;Burgos;Castilla y León;294;151;143
1084;Íscar;Valladolid;Castilla y León;6344;3201;3143
376;Isla Cristina;Huelva;Andalucía;21264;10639;10625
1155;Isla Mayor;Sevilla;Andalucía;5839;2905;2934
3103;Isona i Conca Dellà;Lleida;Cataluña;1019;548;471
5080;Isòvol;Girona;Cataluña;281;161;120
3563;Ispaster;Bizkaia;País Vasco;735;389;346
2618;Istán;Málaga;Andalucía;1469;732;737
7896;Isuerre;Zaragoza;Aragón;31;19;12
6125;Itero de la Vega;Palencia;Castilla y León;152;90;62
7065;Itero del Castillo;Burgos;Castilla y León;80;45;35
3152;Ítrabo;Granada;Andalucía;988;496;492
3731;Itsasondo;Gipuzkoa;País Vasco;658;343;315
5548;Ituero de Azaba;Salamanca;Castilla y León;214;112;102
4584;Ituero y Lama;Segovia;Castilla y León;378;201;177
4105;Ituren;Navarra;Navarra;511;259;252
4491;Iturmendi;Navarra;Navarra;403;208;195
1577;Iurreta;Bizkaia;País Vasco;3662;1810;1852
2560;Ivars d'Urgell;Lleida;Cataluña;1531;801;730
4786;Ivars de Noguera;Lleida;Cataluña;334;171;163
6719;Ivorra;Lleida;Cataluña;104;57;47
2832;Iza/Itza;Navarra;Navarra;1235;666;569
5861;Izagaondoa;Navarra;Navarra;176;114;62
6033;Izagre;León;Castilla y León;159;80;79
7735;Izalzu/Itzaltzu;Navarra;Navarra;40;23;17
1432;Iznájar;Córdoba;Andalucía;4261;2133;2128
1276;Iznalloz;Granada;Andalucía;5134;2641;2493
3331;Iznate;Málaga;Andalucía;868;453;415
3201;Iznatoraf;Jaén;Andalucía;960;496;464
5246;Izurtza;Bizkaia;País Vasco;255;159;96
7334;Jabaloyas;Teruel;Aragón;63;38;25
2222;Jabalquinto;Jaén;Andalucía;2039;1025;1014
2114;Jabugo;Huelva;Andalucía;2250;1132;1118
602;Jaca;Huesca;Aragón;12988;6357;6631
2239;Jacarilla;Alicante/Alacant;Comunidad Valenciana;2022;1030;992
2661;Jadraque;Guadalajara;Castilla-La Mancha;1413;743;670
58;Jaén;Jaén;Andalucía;112999;54420;58579
4571;Jafre;Girona;Cataluña;380;206;174
3388;Jalance;Valencia/València;Comunidad Valenciana;830;425;405
8037;Jalón de Cameros;Rioja, La;La Rioja;21;10;11
6040;Jambrina;Zamora;Castilla y León;159;84;75
1683;Jamilena;Jaén;Andalucía;3293;1668;1625
3687;Jana, la;Castellón/Castelló;Comunidad Valenciana;675;341;334
5090;Jaraba;Zaragoza;Aragón;280;152;128
3527;Jarafuel;Valencia/València;Comunidad Valenciana;754;394;360
4252;Jaraicejo;Cáceres;Extremadura;465;228;237
1069;Jaraíz de la Vera;Cáceres;Extremadura;6478;3240;3238
7610;Jaramillo de la Fuente;Burgos;Castilla y León;48;30;18
8126;Jaramillo Quemado;Burgos;Castilla y León;7;6;1
1843;Jarandilla de la Vera;Cáceres;Extremadura;2828;1415;1413
6301;Jarilla;Cáceres;Extremadura;136;65;71
7289;Jarque de la Val;Teruel;Aragón;66;35;31
4371;Jarque de Moncayo;Zaragoza;Aragón;435;231;204
6901;Jasa;Huesca;Aragón;92;52;40
3837;Játar;Granada;Andalucía;614;339;275
7791;Jatiel;Teruel;Aragón;37;23;14
5389;Jaulín;Zaragoza;Aragón;235;128;107
5727;Jaurrieta;Navarra;Navarra;189;107;82
279;Jávea/Xàbia;Alicante/Alacant;Comunidad Valenciana;27604;13681;13923
6623;Javier;Navarra;Navarra;110;28;82
3048;Jayena;Granada;Andalucía;1060;550;510
26;Jerez de la Frontera;Cádiz;Andalucía;212749;103897;108852
804;Jerez de los Caballeros;Badajoz;Extremadura;9303;4580;4723
3184;Jérez del Marquesado;Granada;Andalucía;968;499;469
2548;Jérica;Castellón/Castelló;Comunidad Valenciana;1548;798;750
2798;Jerte;Cáceres;Extremadura;1261;623;638
3270;Jete;Granada;Andalucía;919;492;427
1024;Jijona/Xixona;Alicante/Alacant;Comunidad Valenciana;6865;3342;3523
2772;Jimena;Jaén;Andalucía;1284;624;660
1018;Jimena de la Frontera;Cádiz;Andalucía;6951;3568;3383
4609;Jimera de Líbar;Málaga;Andalucía;372;192;180
7394;Jirueque;Guadalajara;Castilla-La Mancha;59;41;18
4993;Joarilla de las Matas;León;Castilla y León;296;159;137
659;Jódar;Jaén;Andalucía;11667;5822;5845
1686;Jonquera, La;Girona;Cataluña;3290;1637;1653
3378;Jorba;Barcelona;Cataluña;835;424;411
7913;Jorcas;Teruel;Aragón;30;18;12
4679;Jorquera;Albacete;Castilla-La Mancha;355;193;162
7830;Josa;Teruel;Aragón;34;21;13
6682;Josa i Tuixén;Lleida;Cataluña;106;58;48
3033;Joyosa, La;Zaragoza;Aragón;1073;552;521
7711;Juarros de Riomoros;Segovia;Castilla y León;42;24;18
5647;Juarros de Voltoya;Segovia;Castilla y León;200;98;102
4056;Jubrique;Málaga;Andalucía;528;266;262
4845;Juià;Girona;Cataluña;323;174;149
308;Jumilla;Murcia;Región de Murcia;25600;13305;12295
1529;Jun;Granada;Andalucía;3833;1958;1875
7761;Junciana;Ávila;Castilla y León;38;20;18
4547;Juncosa;Lleida;Cataluña;386;204;182
1628;Juneda;Lleida;Cataluña;3475;1854;1621
6341;Junta de Traslaloma;Burgos;Castilla y León;132;73;59
6958;Junta de Villalba de Losa;Burgos;Castilla y León;88;49;39
7840;Jurisdicción de Lara;Burgos;Castilla y León;33;19;14
7459;Jurisdicción de San Zadornil;Burgos;Castilla y León;56;32;24
3967;Juslapeña;Navarra;Navarra;563;308;255
7166;Justel;Zamora;Castilla y León;75;46;29
6110;Juviles;Granada;Andalucía;153;76;77
5690;Juzbado;Salamanca;Castilla y León;194;99;95
5409;Júzcar;Málaga;Andalucía;232;133;99
1861;Karrantza Harana/Valle de Carranza;Bizkaia;País Vasco;2778;1437;1341
4344;Kortezubi;Bizkaia;País Vasco;441;220;221
5822;Kripan;Araba/Álava;País Vasco;180;94;86
4593;Kuartango;Araba/Álava;País Vasco;376;220;156
6690;Labajos;Segovia;Castilla y León;106;63;43
2636;Labastida/Bastida;Araba/Álava;País Vasco;1452;751;701
3953;Labores, Las;Ciudad Real;Castilla-La Mancha;569;282;287
5997;Labuerda;Huesca;Aragón;162;87;75
1630;Láchar;Granada;Andalucía;3471;1782;1689
5626;Ladrillar;Cáceres;Extremadura;201;109;92
2695;Lagartera;Toledo;Castilla-La Mancha;1369;683;686
6349;Lagartos;Palencia;Castilla y León;132;75;57
6613;Lagata;Zaragoza;Aragón;111;59;52
6052;Lagrán;Araba/Álava;País Vasco;157;87;70
2595;Laguardia;Araba/Álava;País Vasco;1494;767;727
7194;Lagueruela;Teruel;Aragón;73;38;35
3756;Laguna Dalga;León;Castilla y León;645;346;299
6721;Laguna de Cameros;Rioja, La;La Rioja;104;64;40
6553;Laguna de Contreras;Segovia;Castilla y León;114;66;48
351;Laguna de Duero;Valladolid;Castilla y León;22725;11315;11410
3050;Laguna de Negrillos;León;Castilla y León;1058;545;513
7574;Laguna del Marquesado;Cuenca;Castilla-La Mancha;50;28;22
7116;Lagunaseca;Cuenca;Castilla-La Mancha;77;45;32
4250;Lagunilla;Salamanca;Castilla y León;466;252;214
4597;Lagunilla del Jubera;Rioja, La;La Rioja;375;209;166
2439;Lahiguera;Jaén;Andalucía;1710;840;870
2775;Lakuntza;Navarra;Navarra;1279;678;601
405;Lalín;Pontevedra;Galicia;20218;9846;10372
5664;Laluenga;Huesca;Aragón;197;103;94
3294;Lalueza;Huesca;Aragón;892;465;427
2002;Lama, A;Pontevedra;Galicia;2445;1199;1246
5136;Lamasón;Cantabria;Cantabria;272;173;99
5925;Lana;Navarra;Navarra;169;98;71
2901;Lanaja;Huesca;Aragón;1174;621;553
1931;Láncara;Lugo;Galicia;2605;1332;1273
3652;Lanciego/Lantziego;Araba/Álava;País Vasco;691;367;324
2834;Landete;Cuenca;Castilla-La Mancha;1234;633;601
5282;Lanestosa;Bizkaia;País Vasco;251;136;115
4214;Langa;Ávila;Castilla y León;478;253;225
3628;Langa de Duero;Soria;Castilla y León;704;387;317
6465;Langa del Castillo;Zaragoza;Aragón;121;63;58
5310;Langayo;Valladolid;Castilla y León;248;156;92
180;Langreo;Asturias;Principado de Asturias;39420;18787;20633
7024;Languilla;Segovia;Castilla y León;84;51;33
1619;Lanjarón;Granada;Andalucía;3507;1757;1750
5069;Lantadilla;Palencia;Castilla y León;283;151;132
3317;Lantarón;Araba/Álava;País Vasco;875;494;381
3903;Lanteira;Granada;Andalucía;588;316;272
1535;Lantejuela;Sevilla;Andalucía;3814;1945;1869
6175;Lantz;Navarra;Navarra;148;88;60
3391;Lanzahíta;Ávila;Castilla y León;828;423;405
8029;Lanzuela;Teruel;Aragón;22;16;6
5079;Lapa, La;Badajoz;Extremadura;281;143;138
6918;Laperdiguera;Huesca;Aragón;91;47;44
6470;Lapoblación;Navarra;Navarra;120;68;52
3334;Lapuebla de Labarca;Araba/Álava;País Vasco;865;439;426
677;Laracha, A;Coruña, A;Galicia;11347;5591;5756
722;Lardero;Rioja, La;La Rioja;10500;5262;5238
692;Laredo;Cantabria;Cantabria;11025;5217;5808
4396;Larouco;Ourense;Galicia;429;207;222
5701;Laroya;Almería;Andalucía;192;111;81
2227;Larrabetzu;Bizkaia;País Vasco;2033;981;1052
2199;Larraga;Navarra;Navarra;2075;1088;987
6760;Larraona;Navarra;Navarra;102;49;53
5283;Larraul;Gipuzkoa;País Vasco;251;138;113
3218;Larraun;Navarra;Navarra;951;522;429
5747;Larrodrigo;Salamanca;Castilla y León;187;108;79
4232;Larva;Jaén;Andalucía;472;243;229
449;Lasarte-Oria;Gipuzkoa;País Vasco;18380;8899;9481
6370;Lascellas-Ponzano;Huesca;Aragón;129;82;47
6345;Lascuarre;Huesca;Aragón;132;68;64
5420;Laspaúles;Huesca;Aragón;230;135;95
4978;Laspuña;Huesca;Aragón;298;161;137
4670;Lastras de Cuéllar;Segovia;Castilla y León;358;186;172
7318;Lastras del Pozo;Segovia;Castilla y León;64;34;30
1511;Lastrilla, La;Segovia;Castilla y León;3891;1976;1915
457;Laudio/Llodio;Araba/Álava;País Vasco;18102;8868;9234
2554;Láujar de Andarax;Almería;Andalucía;1536;766;770
2871;Laukiz;Bizkaia;País Vasco;1194;598;596
604;Laviana;Asturias;Principado de Asturias;12977;6214;6763
1764;Laxe;Coruña, A;Galicia;3016;1515;1501
6838;Layana;Zaragoza;Aragón;97;52;45
3526;Layos;Toledo;Castilla-La Mancha;754;370;384
2842;Laza;Ourense;Galicia;1228;641;587
5728;Lazagurría;Navarra;Navarra;189;97;92
1165;Lazkao;Gipuzkoa;País Vasco;5742;2887;2855
4608;Leaburu;Gipuzkoa;País Vasco;372;199;173
7906;Leache/Leatxe;Navarra;Navarra;30;17;13
281;Lebrija;Sevilla;Andalucía;27524;13735;13789
3791;Lécera;Zaragoza;Aragón;633;345;288
7572;Lechón;Zaragoza;Aragón;51;29;22
2930;Leciñena;Zaragoza;Aragón;1155;588;567
2172;Lecrín;Granada;Andalucía;2134;1076;1058
6812;Ledanca;Guadalajara;Castilla-La Mancha;98;50;48
2540;Ledaña;Cuenca;Castilla-La Mancha;1563;772;791
2514;Ledesma;Salamanca;Castilla y León;1599;799;800
8093;Ledesma de la Cogolla;Rioja, La;La Rioja;15;12;3
7316;Ledigos;Palencia;Castilla y León;64;31;33
4201;Ledrada;Salamanca;Castilla y León;481;241;240
33;Leganés;Madrid;Comunidad de Madrid;189861;91999;97862
5715;Leganiel;Cuenca;Castilla-La Mancha;190;98;92
6511;Legarda;Navarra;Navarra;117;65;52
6604;Legaria;Navarra;Navarra;111;50;61
882;Legazpi;Gipuzkoa;País Vasco;8371;4227;4144
2656;Legorreta;Gipuzkoa;País Vasco;1417;716;701
2308;Legutio;Araba/Álava;País Vasco;1885;995;890
5391;Leintz-Gatzaga;Gipuzkoa;País Vasco;234;126;108
234;Leioa;Bizkaia;País Vasco;31795;15498;16297
2536;Leiro;Ourense;Galicia;1568;763;805
1810;Leitza;Navarra;Navarra;2913;1513;1400
5489;Leiva;Rioja, La;La Rioja;221;109;112
982;Lekeitio;Bizkaia;País Vasco;7307;3609;3698
2556;Lekunberri;Navarra;Navarra;1536;769;767
1622;Lemoa;Bizkaia;País Vasco;3486;1741;1745
2829;Lemoiz;Bizkaia;País Vasco;1238;654;584
701;Lena;Asturias;Principado de Asturias;10890;5223;5667
4829;Lentegí;Granada;Andalucía;326;169;157
53;León;León;Castilla y León;124303;56307;67996
5500;Leoz/Leotz;Navarra;Navarra;220;142;78
286;Lepe;Huelva;Andalucía;27431;14027;13404
7492;Lerga;Navarra;Navarra;55;35;20
2429;Lerín;Navarra;Navarra;1725;887;838
1968;Lerma;Burgos;Castilla y León;2529;1270;1259
3228;Les;Lleida;Cataluña;946;463;483
1876;Lesaka;Navarra;Navarra;2741;1407;1334
3269;Letur;Albacete;Castilla-La Mancha;919;449;470
4649;Letux;Zaragoza;Aragón;364;199;165
5617;Leza;Araba/Álava;País Vasco;203;100;103
7708;Leza de Río Leza;Rioja, La;La Rioja;42;25;17
2021;Lezama;Bizkaia;País Vasco;2412;1197;1215
5341;Lezaun;Navarra;Navarra;242;146;96
1113;Lezo;Gipuzkoa;País Vasco;6122;3051;3071
2705;Lezuza;Albacete;Castilla-La Mancha;1358;705;653
1242;Librilla;Murcia;Región de Murcia;5305;2728;2577
6764;Libros;Teruel;Aragón;102;64;38
7605;Liceras;Soria;Castilla y León;49;25;24
7451;Lidón;Teruel;Aragón;57;31;26
5018;Liédena;Navarra;Navarra;292;144;148
2863;Liendo;Cantabria;Cantabria;1204;621;583
2038;Liérganes;Cantabria;Cantabria;2379;1168;1211
2897;Liétor;Albacete;Castilla-La Mancha;1175;610;565
4528;Líjar;Almería;Andalucía;390;207;183
1949;Lillo;Toledo;Castilla-La Mancha;2577;1333;1244
2313;Limpias;Cantabria;Cantabria;1879;926;953
131;Linares;Jaén;Andalucía;57414;28059;29355
5188;Linares de la Sierra;Huelva;Andalucía;263;127;136
5393;Linares de Mora;Teruel;Aragón;234;137;97
3222;Linares de Riofrío;Salamanca;Castilla y León;949;517;432
120;Línea de la Concepción, La;Cádiz;Andalucía;63147;30978;32169
1893;Linyola;Lleida;Cataluña;2700;1365;1335
6018;Litago;Zaragoza;Aragón;161;92;69
6475;Lituénigo;Zaragoza;Aragón;120;62;58
3864;Lizartza;Gipuzkoa;País Vasco;603;312;291
5000;Lizoáin-Arriasgoiti;Navarra;Navarra;295;172;123
3327;Llacuna, La;Barcelona;Cataluña;870;475;395
3408;Lladó;Girona;Cataluña;818;398;420
5421;Lladorre;Lleida;Cataluña;230;116;114
5860;Lladurs;Lleida;Cataluña;176;91;85
585;Llagosta, La;Barcelona;Cataluña;13480;6675;6805
870;Llagostera;Girona;Cataluña;8453;4303;4150
3398;Llamas de la Ribera;León;Castilla y León;825;437;388
3640;Llambilles;Girona;Cataluña;696;359;337
4124;Llanars;Girona;Cataluña;505;259;246
1329;Llançà;Girona;Cataluña;4836;2394;2442
580;Llanera;Asturias;Principado de Asturias;13702;6792;6910
3054;Llanera de Ranes;Valencia/València;Comunidad Valenciana;1055;529;526
583;Llanes;Asturias;Principado de Asturias;13568;6584;6984
7407;Llano de Bureba;Burgos;Castilla y León;58;37;21
7402;Llano de Olmedo;Valladolid;Castilla y León;59;32;27
396;Llanos de Aridane, Los;Santa Cruz de Tenerife;Canarias;20467;9908;10559
7375;Llanos de Tormes, Los;Ávila;Castilla y León;60;27;33
3597;Llanos del Caudillo;Ciudad Real;Castilla-La Mancha;719;354;365
4303;Llardecans;Lleida;Cataluña;451;236;215
2907;Llaurí;Valencia/València;Comunidad Valenciana;1170;607;563
4692;Llavorsí;Lleida;Cataluña;352;180;172
6037;Lledó;Teruel;Aragón;159;82;77
47;Lleida;Lleida;Cataluña;138956;68657;70299
3373;Llera;Badajoz;Extremadura;836;426;410
1158;Llerena;Badajoz;Extremadura;5804;2878;2926
2827;Llers;Girona;Cataluña;1239;617;622
5264;Lles de Cerdanya;Lleida;Cataluña;253;148;105
3242;Llíber;Alicante/Alacant;Comunidad Valenciana;935;474;461
534;Lliçà d'Amunt;Barcelona;Cataluña;15256;7819;7437
1060;Lliçà de Vall;Barcelona;Cataluña;6542;3335;3207
6206;Llimiana;Lleida;Cataluña;145;88;57
760;Llinars del Vallès;Barcelona;Cataluña;9938;4946;4992
346;Llíria;Valencia/València;Comunidad Valenciana;23253;11767;11486
2657;Llívia;Girona;Cataluña;1417;748;669
6668;Lloar, El;Tarragona;Cataluña;107;58;49
5737;Llobera;Lleida;Cataluña;188;104;84
3278;Llocnou d'En Fenollet;Valencia/València;Comunidad Valenciana;916;476;440
6499;Llocnou de la Corona;Valencia/València;Comunidad Valenciana;118;64;54
4002;Llocnou de Sant Jeroni;Valencia/València;Comunidad Valenciana;546;276;270
1899;Llombai;Valencia/València;Comunidad Valenciana;2685;1351;1334
6793;Llorac;Tarragona;Cataluña;100;52;48
2033;Llorenç del Penedès;Tarragona;Cataluña;2393;1172;1221
186;Lloret de Mar;Girona;Cataluña;38373;19528;18845
2690;Lloret de Vistalegre;Balears, Illes;Islas Baleares;1372;694;678
1595;Llosa de Ranes, la;Valencia/València;Comunidad Valenciana;3575;1833;1742
3217;Llosa, la;Castellón/Castelló;Comunidad Valenciana;951;467;484
1133;Lloseta;Balears, Illes;Islas Baleares;5988;3009;2979
5512;Llosses, Les;Girona;Cataluña;218;121;97
2094;Llubí;Balears, Illes;Islas Baleares;2273;1140;1133
5129;Lluçà;Barcelona;Cataluña;273;134;139
2758;Llucena/Lucena del Cid;Castellón/Castelló;Comunidad Valenciana;1302;653;649
197;Llucmajor;Balears, Illes;Islas Baleares;36914;18702;18212
2054;Llutxent;Valencia/València;Comunidad Valenciana;2345;1200;1145
4764;Loarre;Huesca;Aragón;338;189;149
3441;Lobeira;Ourense;Galicia;798;390;408
7951;Lobera de Onsella;Zaragoza;Aragón;28;15;13
2440;Lobios;Ourense;Galicia;1708;863;845
1874;Lobón;Badajoz;Extremadura;2746;1408;1338
6205;Lobras;Granada;Andalucía;145;75;70
1332;Lodosa;Navarra;Navarra;4816;2442;2374
845;Loeches;Madrid;Comunidad de Madrid;8791;4400;4391
42;Logroño;Rioja, La;La Rioja;151136;71718;79418
2259;Logrosán;Cáceres;Extremadura;1994;1006;988
2011;Loiu;Bizkaia;País Vasco;2433;1239;1194
400;Loja;Granada;Andalucía;20342;10117;10225
5681;Loma de Ucieza;Palencia;Castilla y León;195;113;82
7563;Lomas;Palencia;Castilla y León;51;32;19
2037;Lominchar;Toledo;Castilla-La Mancha;2387;1258;1129
5867;Lomoviejo;Valladolid;Castilla y León;176;94;82
3426;Longares;Zaragoza;Aragón;811;478;333
7897;Longás;Zaragoza;Aragón;31;21;10
4979;Lónguida/Longida;Navarra;Navarra;298;159;139
1575;Lopera;Jaén;Andalucía;3665;1855;1810
4045;Loporzano;Huesca;Aragón;530;300;230
3338;Lora de Estepa;Sevilla;Andalucía;862;441;421
442;Lora del Río;Sevilla;Andalucía;18662;9233;9429
2817;Loranca de Tajuña;Guadalajara;Castilla-La Mancha;1249;681;568
70;Lorca;Murcia;Región de Murcia;94404;48331;46073
3933;Lorcha/Orxa, l';Alicante/Alacant;Comunidad Valenciana;578;284;294
2236;Loriguilla;Valencia/València;Comunidad Valenciana;2025;1036;989
996;Lorquí;Murcia;Región de Murcia;7141;3611;3530
4116;Losa del Obispo;Valencia/València;Comunidad Valenciana;507;261;246
4079;Losa, La;Segovia;Castilla y León;521;291;230
5539;Losacino;Zamora;Castilla y León;215;121;94
6778;Losacio;Zamora;Castilla y León;101;56;45
1894;Losar de la Vera;Cáceres;Extremadura;2699;1380;1319
6700;Losar del Barco, El;Ávila;Castilla y León;105;53;52
6803;Loscorrales;Huesca;Aragón;99;50;49
6447;Loscos;Teruel;Aragón;122;74;48
8102;Losilla, La;Soria;Castilla y León;14;10;4
2165;Lourenzá;Lugo;Galicia;2140;1040;1100
1664;Lousame;Coruña, A;Galicia;3338;1647;1691
3925;Lozoya;Madrid;Comunidad de Madrid;581;309;272
2759;Lozoyuela-Navas-Sieteiglesias;Madrid;Comunidad de Madrid;1299;670;629
4938;Lubián;Zamora;Castilla y León;307;160;147
2607;Lubrín;Almería;Andalucía;1477;736;741
4019;Lucainena de las Torres;Almería;Andalucía;538;287;251
3501;Lúcar;Almería;Andalucía;763;373;390
165;Lucena;Córdoba;Andalucía;42605;21251;21354
5353;Lucena de Jalón;Zaragoza;Aragón;240;130;110
1658;Lucena del Puerto;Huelva;Andalucía;3371;1757;1614
3207;Luceni;Zaragoza;Aragón;956;488;468
4635;Luciana;Ciudad Real;Castilla-La Mancha;366;196;170
4594;Lucillo;León;Castilla y León;376;199;177
3900;Lucillos;Toledo;Castilla-La Mancha;589;312;277
6251;Ludiente;Castellón/Castelló;Comunidad Valenciana;141;78;63
6106;Luelmo;Zamora;Castilla y León;154;84;70
3884;Luena;Cantabria;Cantabria;593;321;272
5044;Luesia;Zaragoza;Aragón;288;160;128
7819;Luesma;Zaragoza;Aragón;35;21;14
64;Lugo;Lugo;Galicia;98276;45508;52768
4846;Lugros;Granada;Andalucía;323;171;152
1375;Luisiana, La;Sevilla;Andalucía;4576;2313;2263
4178;Lújar;Granada;Andalucía;488;263;225
2745;Lumbier;Navarra;Navarra;1318;716;602
2518;Lumbrales;Salamanca;Castilla y León;1590;801;789
6102;Lumbreras;Rioja, La;La Rioja;154;105;49
3420;Lumpiaque;Zaragoza;Aragón;814;422;392
3638;Luna;Zaragoza;Aragón;698;367;331
5231;Lupiana;Guadalajara;Castilla-La Mancha;257;135;122
4746;Lupiñén-Ortilla;Huesca;Aragón;342;171;171
3364;Lupión;Jaén;Andalucía;842;413;429
1778;Luque;Córdoba;Andalucía;2994;1503;1491
6347;Luquin;Navarra;Navarra;132;70;62
3801;Luyego;León;Castilla y León;628;336;292
7238;Luzaga;Guadalajara;Castilla-La Mancha;69;38;31
4813;Luzaide/Valcarlos;Navarra;Navarra;329;178;151
7251;Luzón;Guadalajara;Castilla-La Mancha;68;33;35
1206;Macael;Almería;Andalucía;5482;2803;2679
3659;Maçanet de Cabrenys;Girona;Cataluña;688;340;348
1012;Maçanet de la Selva;Girona;Cataluña;7006;3598;3408
2773;Macastre;Valencia/València;Comunidad Valenciana;1283;681;602
1825;Maceda;Ourense;Galicia;2872;1408;1464
4290;Machacón;Salamanca;Castilla y León;454;238;216
4206;Macharaviaya;Málaga;Andalucía;480;259;221
3077;Macotera;Salamanca;Castilla y León;1037;529;508
7617;Madarcos;Madrid;Comunidad de Madrid;48;30;18
5752;Maderal, El;Zamora;Castilla y León;187;100;87
5938;Maderuelo;Segovia;Castilla y León;168;99;69
5066;Madremanya;Girona;Cataluña;283;138;145
1;Madrid;Madrid;Comunidad de Madrid;3266126;1520153;1745973
4272;Madridanos;Zamora;Castilla y León;458;241;217
724;Madridejos;Toledo;Castilla-La Mancha;10453;5228;5225
2526;Madrigal de la Vera;Cáceres;Extremadura;1579;818;761
2659;Madrigal de las Altas Torres;Ávila;Castilla y León;1415;717;698
6221;Madrigal del Monte;Burgos;Castilla y León;143;88;55
2410;Madrigalejo;Cáceres;Extremadura;1751;881;870
5952;Madrigalejo del Monte;Burgos;Castilla y León;166;110;56
1355;Madrigueras;Albacete;Castilla-La Mancha;4652;2380;2272
6247;Madroñal;Salamanca;Castilla y León;142;77;65
1965;Madroñera;Cáceres;Extremadura;2533;1256;1277
5102;Madroño, El;Sevilla;Andalucía;278;140;138
2268;Maella;Zaragoza;Aragón;1985;1076;909
3882;Maello;Ávila;Castilla y León;594;308;286
4043;Magacela;Badajoz;Extremadura;530;272;258
2963;Magallón;Zaragoza;Aragón;1128;576;552
1605;Magán;Toledo;Castilla-La Mancha;3544;1786;1758
7243;Magaña;Soria;Castilla y León;69;39;30
4667;Magaz de Cepeda;León;Castilla y León;359;187;172
3123;Magaz de Pisuerga;Palencia;Castilla y León;1005;530;475
3170;Maguilla;Badajoz;Extremadura;974;480;494
6636;Mahamud;Burgos;Castilla y León;109;60;49
4779;Mahide;Zamora;Castilla y León;336;190;146
2678;Mahora;Albacete;Castilla-La Mancha;1383;706;677
4309;Maià de Montcal;Girona;Cataluña;449;251;198
3268;Maials;Lleida;Cataluña;920;517;403
7949;Maicas;Teruel;Aragón;28;15;13
5218;Maíllo, El;Salamanca;Castilla y León;260;146;114
6098;Mainar;Zaragoza;Aragón;155;88;67
6202;Maire de Castroponce;Zamora;Castilla y León;146;75;71
340;Mairena del Alcor;Sevilla;Andalucía;23550;11781;11769
158;Mairena del Aljarafe;Sevilla;Andalucía;46089;22428;23661
105;Majadahonda;Madrid;Comunidad de Madrid;71826;34018;37808
2740;Majadas;Cáceres;Extremadura;1323;664;659
5343;Majadas, Las;Cuenca;Castilla-La Mancha;241;126;115
7560;Majaelrayo;Guadalajara;Castilla-La Mancha;51;29;22
8118;Maján;Soria;Castilla y León;10;6;4
6;Málaga;Málaga;Andalucía;574654;276001;298653
5828;Málaga del Fresno;Guadalajara;Castilla-La Mancha;180;97;83
902;Malagón;Ciudad Real;Castilla-La Mancha;7998;3939;4059
6123;Malaguilla;Guadalajara;Castilla-La Mancha;152;82;70
2384;Malahá, La;Granada;Andalucía;1781;897;884
6911;Malanquilla;Zaragoza;Aragón;92;60;32
4639;Malcocinado;Badajoz;Extremadura;365;198;167
5497;Maldà;Lleida;Cataluña;220;109;111
5225;Maleján;Zaragoza;Aragón;259;133;126
445;Malgrat de Mar;Barcelona;Cataluña;18579;9280;9299
5130;Malla;Barcelona;Cataluña;273;139;134
2925;Mallabia;Bizkaia;País Vasco;1158;592;566
1760;Mallén;Zaragoza;Aragón;3035;1577;1458
4678;Malón;Zaragoza;Aragón;356;180;176
6820;Malpartida;Salamanca;Castilla y León;98;52;46
1469;Malpartida de Cáceres;Cáceres;Extremadura;4122;2079;2043
6798;Malpartida de Corneja;Ávila;Castilla y León;99;50;49
3980;Malpartida de la Serena;Badajoz;Extremadura;556;290;266
1370;Malpartida de Plasencia;Cáceres;Extremadura;4602;2276;2326
1226;Malpica de Bergantiños;Coruña, A;Galicia;5391;2631;2760
2441;Malpica de Tajo;Toledo;Castilla-La Mancha;1705;881;824
3264;Maluenda;Zaragoza;Aragón;922;452;470
6436;Malva;Zamora;Castilla y León;123;55;68
5613;Mamblas;Ávila;Castilla y León;204;117;87
6732;Mambrilla de Castrejón;Burgos;Castilla y León;103;61;42
7408;Mambrillas de Lara;Burgos;Castilla y León;58;35;23
7931;Mamolar;Burgos;Castilla y León;28;21;7
163;Manacor;Balears, Illes;Islas Baleares;43808;21927;21881
5624;Mancera de Abajo;Salamanca;Castilla y León;202;107;95
7168;Mancera de Arriba;Ávila;Castilla y León;74;38;36
682;Mancha Real;Jaén;Andalucía;11264;5584;5680
3494;Manchita;Badajoz;Extremadura;765;385;380
6556;Manchones;Zaragoza;Aragón;114;61;53
8009;Manciles;Burgos;Castilla y León;22;14;8
2575;Mancor de la Vall;Balears, Illes;Islas Baleares;1509;763;746
5004;Mandayona;Guadalajara;Castilla-La Mancha;294;143;151
4217;Manganeses de la Lampreana;Zamora;Castilla y León;478;239;239
3790;Manganeses de la Polvorosa;Zamora;Castilla y León;633;309;324
523;Manilva;Málaga;Andalucía;15528;7856;7672
243;Manises;Valencia/València;Comunidad Valenciana;30919;15266;15653
7989;Manjabálago y Ortigosa de Rioalmar;Ávila;Castilla y León;24;15;9
6460;Manjarrés;Rioja, La;La Rioja;121;72;49
392;Manlleu;Barcelona;Cataluña;20573;10314;10259
7285;Manquillos;Palencia;Castilla y León;66;36;30
96;Manresa;Barcelona;Cataluña;77714;38066;39648
7470;Mansilla de la Sierra;Rioja, La;La Rioja;56;41;15
2422;Mansilla de las Mulas;León;Castilla y León;1733;868;865
4785;Mansilla Mayor;León;Castilla y León;334;181;153
7824;Mantiel;Guadalajara;Castilla-La Mancha;34;22;12
6255;Mantinos;Palencia;Castilla y León;141;79;62
2014;Manuel;Valencia/València;Comunidad Valenciana;2428;1196;1232
4647;Manzanal de Arriba;Zamora;Castilla y León;364;190;174
6437;Manzanal de los Infantes;Zamora;Castilla y León;123;68;55
6408;Manzanal del Barco;Zamora;Castilla y León;126;66;60
458;Manzanares;Ciudad Real;Castilla-La Mancha;17997;8919;9078
7240;Manzanares de Rioja;Rioja, La;La Rioja;69;40;29
843;Manzanares el Real;Madrid;Comunidad de Madrid;8840;4474;4366
3329;Manzaneda;Ourense;Galicia;870;422;448
4560;Manzaneque;Toledo;Castilla-La Mancha;383;184;199
4042;Manzanera;Teruel;Aragón;531;285;246
2171;Manzanilla;Huelva;Andalucía;2135;1092;1043
7547;Manzanillo;Valladolid;Castilla y León;52;26;26
7252;Manzano, El;Salamanca;Castilla y León;68;36;32
4097;Mañaria;Bizkaia;País Vasco;515;263;252
4375;Mañeru;Navarra;Navarra;434;229;205
2708;Mañón;Coruña, A;Galicia;1356;665;691
266;Maó-Mahón;Balears, Illes;Islas Baleares;29040;14147;14893
4360;Maqueda;Toledo;Castilla-La Mancha;438;219;219
5942;Mara;Zaragoza;Aragón;168;83;85
363;Maracena;Granada;Andalucía;22116;10858;11258
5425;Maranchón;Guadalajara;Castilla-La Mancha;229;121;108
6538;Maraña;León;Castilla y León;115;67;48
7539;Marañón;Navarra;Navarra;52;26;26
6776;Marazoleja;Segovia;Castilla y León;101;65;36
7584;Marazuela;Segovia;Castilla y León;50;29;21
46;Marbella;Málaga;Andalucía;143386;68944;74442
3883;Marçà;Tarragona;Cataluña;594;314;280
5594;Marchagaz;Cáceres;Extremadura;207;105;102
4430;Marchal;Granada;Andalucía;417;196;221
957;Marchamalo;Guadalajara;Castilla-La Mancha;7474;3723;3751
422;Marchena;Sevilla;Andalucía;19457;9689;9768
1829;Marcilla;Navarra;Navarra;2858;1447;1411
7645;Marcilla de Campos;Palencia;Castilla y León;46;21;25
6836;Margalef;Tarragona;Cataluña;97;59;38
5167;Marganell;Barcelona;Cataluña;266;131;135
2828;María;Almería;Andalucía;1238;637;601
1156;María de Huerva;Zaragoza;Aragón;5812;2961;2851
2123;Maria de la Salut;Balears, Illes;Islas Baleares;2227;1156;1071
4948;Mariana;Cuenca;Castilla-La Mancha;304;157;147
327;Marín;Pontevedra;Galicia;24319;12153;12166
1280;Marina de Cudeyo;Cantabria;Cantabria;5125;2547;2578
1922;Marinaleda;Sevilla;Andalucía;2627;1330;1297
2348;Marines;Valencia/València;Comunidad Valenciana;1828;966;862
4511;Marines, Los;Huelva;Andalucía;396;212;184
5317;Marjaliza;Toledo;Castilla-La Mancha;247;120;127
1300;Markina-Xemein;Bizkaia;País Vasco;5006;2542;2464
7899;Marlín;Ávila;Castilla y León;30;19;11
1027;Marmolejo;Jaén;Andalucía;6812;3394;3418
6999;Marracos;Zaragoza;Aragón;86;53;33
194;Marratxí;Balears, Illes;Islas Baleares;37193;18735;18458
6038;Marrupe;Toledo;Castilla-La Mancha;159;78;81
5191;Martiago;Salamanca;Castilla y León;263;140;123
4910;Martiherrero;Ávila;Castilla y León;312;158;154
1889;Martín de la Jara;Sevilla;Andalucía;2704;1387;1317
4441;Martín de Yeltes;Salamanca;Castilla y León;415;215;200
4498;Martín del Río;Teruel;Aragón;401;195;206
5563;Martín Miguel;Segovia;Castilla y León;212;128;84
5386;Martín Muñoz de la Dehesa;Segovia;Castilla y León;235;123;112
5099;Martín Muñoz de las Posadas;Segovia;Castilla y León;279;148;131
7005;Martinamor;Salamanca;Castilla y León;85;53;32
6519;Martínez;Ávila;Castilla y León;116;60;56
272;Martorell;Barcelona;Cataluña;28189;14329;13860
1333;Martorelles;Barcelona;Cataluña;4801;2422;2379
331;Martos;Jaén;Andalucía;24215;12012;12203
3810;Marugán;Segovia;Castilla y León;623;337;286
3147;Maruri-Jatabe;Bizkaia;País Vasco;991;511;480
7662;Marzales;Valladolid;Castilla y León;45;22;23
3935;Mas de Barberans;Tarragona;Cataluña;578;288;290
2797;Mas de las Matas;Teruel;Aragón;1262;657;605
5038;Masarac;Girona;Cataluña;288;150;138
4343;Mascaraque;Toledo;Castilla-La Mancha;442;230;212
3036;Masdenverge;Tarragona;Cataluña;1070;546;524
7313;Masegosa;Cuenca;Castilla-La Mancha;64;37;27
6614;Masegoso;Albacete;Castilla-La Mancha;110;59;51
7536;Masegoso de Tajuña;Guadalajara;Castilla-La Mancha;52;29;23
1888;Maside;Ourense;Galicia;2705;1337;1368
3633;Masies de Roda, Les;Barcelona;Cataluña;700;355;345
1722;Masies de Voltregà, Les;Barcelona;Cataluña;3141;1551;1590
4131;Masllorenç;Tarragona;Cataluña;504;283;221
341;Masnou, El;Barcelona;Cataluña;23515;11357;12158
5114;Masó, La;Tarragona;Cataluña;276;146;130
3394;Maspujols;Tarragona;Cataluña;827;426;401
810;Masquefa;Barcelona;Cataluña;9211;4641;4570
4147;Masroig, El;Tarragona;Cataluña;497;270;227
2515;Massalavés;Valencia/València;Comunidad Valenciana;1596;843;753
3876;Massalcoreig;Lleida;Cataluña;598;338;260
1998;Massalfassar;Valencia/València;Comunidad Valenciana;2469;1230;1239
512;Massamagrell;Valencia/València;Comunidad Valenciana;15952;7889;8063
776;Massanassa;Valencia/València;Comunidad Valenciana;9667;4794;4873
3506;Massanes;Girona;Cataluña;761;405;356
5513;Massoteres;Lleida;Cataluña;218;119;99
5138;Masueco;Salamanca;Castilla y León;272;139;133
4943;Mata de Alcántara;Cáceres;Extremadura;305;157;148
5172;Mata de Cuéllar;Segovia;Castilla y León;266;139;127
6821;Mata de Ledesma, La;Salamanca;Castilla y León;98;55;43
5236;Mata de los Olmos, La;Teruel;Aragón;257;130;127
5953;Mata de Morella, la;Castellón/Castelló;Comunidad Valenciana;166;90;76
3369;Mata, La;Toledo;Castilla-La Mancha;838;415;423
6063;Matabuena;Segovia;Castilla y León;157;87;70
5437;Matadeón de los Oteros;León;Castilla y León;228;118;110
801;Matadepera;Barcelona;Cataluña;9326;4657;4669
7288;Matalebreras;Soria;Castilla y León;66;40;26
2787;Matallana de Torío;León;Castilla y León;1270;667;603
5041;Matamala de Almazán;Soria;Castilla y León;288;152;136
5960;Matanza;León;Castilla y León;165;89;76
825;Matanza de Acentejo, La;Santa Cruz de Tenerife;Canarias;9061;4585;4476
3051;Matapozuelos;Valladolid;Castilla y León;1058;539;519
52;Mataró;Barcelona;Cataluña;128265;63637;64628
7223;Matarrubia;Guadalajara;Castilla-La Mancha;70;43;27
7015;Matet;Castellón/Castelló;Comunidad Valenciana;84;43;41
5928;Matilla de Arzón;Zamora;Castilla y León;169;98;71
6765;Matilla de los Caños;Valladolid;Castilla y León;102;60;42
3780;Matilla de los Caños del Río;Salamanca;Castilla y León;635;320;315
7714;Matilla la Seca;Zamora;Castilla y León;42;24;18
7025;Matilla, La;Segovia;Castilla y León;84;50;34
6705;Matillas;Guadalajara;Castilla-La Mancha;105;58;47
6819;Matute;Rioja, La;La Rioja;98;56;42
5999;Maya, La;Salamanca;Castilla y León;162;99;63
5818;Mayalde;Zamora;Castilla y León;182;99;83
2576;Mayorga;Valladolid;Castilla y León;1509;748;761
4077;Mazaleón;Teruel;Aragón;522;277;245
2826;Mazarambroz;Toledo;Castilla-La Mancha;1241;641;600
7766;Mazarete;Guadalajara;Castilla-La Mancha;38;18;20
1513;Mazaricos;Coruña, A;Galicia;3885;1855;2030
5501;Mazariegos;Palencia;Castilla y León;220;131;89
230;Mazarrón;Murcia;Región de Murcia;32209;16654;15555
2184;Mazcuerras;Cantabria;Cantabria;2105;1082;1023
5158;Mazuecos;Guadalajara;Castilla-La Mancha;268;148;120
6817;Mazuecos de Valdeginate;Palencia;Castilla y León;98;61;37
7432;Mazuela;Burgos;Castilla y León;57;33;24
1249;Meaño;Pontevedra;Galicia;5272;2570;2702
5637;Mecerreyes;Burgos;Castilla y León;200;106;94
560;Meco;Madrid;Comunidad de Madrid;14305;7211;7094
2104;Medellín;Badajoz;Extremadura;2263;1132;1131
4268;Mediana de Aragón;Zaragoza;Aragón;461;231;230
6575;Mediana de Voltoya;Ávila;Castilla y León;112;55;57
2883;Medina de las Torres;Badajoz;Extremadura;1184;613;571
1168;Medina de Pomar;Burgos;Castilla y León;5728;2914;2814
1357;Medina de Rioseco;Valladolid;Castilla y León;4647;2286;2361
393;Medina del Campo;Valladolid;Castilla y León;20510;9958;10552
658;Medina Sidonia;Cádiz;Andalucía;11708;5950;5758
3610;Medinaceli;Soria;Castilla y León;713;363;350
6855;Medinilla;Ávila;Castilla y León;95;43;52
945;Medio Cudeyo;Cantabria;Cantabria;7556;3663;3893
2066;Mediona;Barcelona;Cataluña;2322;1159;1163
7283;Medranda;Guadalajara;Castilla-La Mancha;66;36;30
4766;Medrano;Rioja, La;La Rioja;338;181;157
4394;Megeces;Valladolid;Castilla y León;430;230;200
7868;Megina;Guadalajara;Castilla-La Mancha;32;18;14
2427;Meira;Lugo;Galicia;1725;865;860
1334;Meis;Pontevedra;Galicia;4791;2290;2501
2782;Mejorada;Toledo;Castilla-La Mancha;1275;661;614
344;Mejorada del Campo;Madrid;Comunidad de Madrid;23274;11540;11734
6596;Melgar de Abajo;Valladolid;Castilla y León;112;61;51
6188;Melgar de Arriba;Valladolid;Castilla y León;147;82;65
2543;Melgar de Fernamental;Burgos;Castilla y León;1559;840;719
4606;Melgar de Tera;Zamora;Castilla y León;373;193;180
5285;Melgar de Yuso;Palencia;Castilla y León;251;145;106
708;Meliana;Valencia/València;Comunidad Valenciana;10822;5309;5513
3569;Mélida;Navarra;Navarra;733;374;359
968;Melide;Coruña, A;Galicia;7406;3654;3752
76;Melilla;Melilla;Melilla;86487;43894;42593
2886;Melón;Ourense;Galicia;1184;565;619
7253;Melque de Cercos;Segovia;Castilla y León;68;36;32
7804;Membibre de la Hoz;Segovia;Castilla y León;36;19;17
6482;Membribe de la Sierra;Salamanca;Castilla y León;119;72;47
1129;Membrilla;Ciudad Real;Castilla-La Mancha;6005;3009;2996
6813;Membrillera;Guadalajara;Castilla-La Mancha;98;54;44
3813;Membrío;Cáceres;Extremadura;622;306;316
3433;Menàrguens;Lleida;Cataluña;806;440;366
1909;Menasalbas;Toledo;Castilla-La Mancha;2651;1399;1252
2255;Mendaro;Gipuzkoa;País Vasco;1999;1002;997
4555;Mendata;Bizkaia;País Vasco;383;197;186
1604;Mendavia;Navarra;Navarra;3547;1824;1723
5048;Mendaza;Navarra;Navarra;287;149;138
4356;Mendexa;Bizkaia;País Vasco;438;220;218
3013;Mendigorría;Navarra;Navarra;1086;563;523
6419;Meneses de Campos;Palencia;Castilla y León;124;67;57
4225;Mengabril;Badajoz;Extremadura;475;260;215
7386;Mengamuñoz;Ávila;Castilla y León;59;29;30
759;Mengíbar;Jaén;Andalucía;9941;4946;4995
1285;Méntrida;Toledo;Castilla-La Mancha;5099;2614;2485
3505;Meñaka;Bizkaia;País Vasco;761;396;365
2065;Mequinenza;Zaragoza;Aragón;2324;1180;1144
6715;Meranges;Girona;Cataluña;104;58;46
2298;Merca, A;Ourense;Galicia;1913;943;970
1294;Mercadal, Es;Balears, Illes;Islas Baleares;5038;2542;2496
126;Mérida;Badajoz;Extremadura;59335;28918;30417
4984;Merindad de Cuesta-Urria;Burgos;Castilla y León;297;163;134
3582;Merindad de Montija;Burgos;Castilla y León;725;432;293
2644;Merindad de Río Ubierna;Burgos;Castilla y León;1444;804;640
4462;Merindad de Sotoscueva;Burgos;Castilla y León;409;225;184
4412;Merindad de Valdeporres;Burgos;Castilla y León;423;220;203
4537;Merindad de Valdivielso;Burgos;Castilla y León;388;223;165
2233;Meruelo;Cantabria;Cantabria;2028;1013;1015
5992;Mesas de Ibor;Cáceres;Extremadura;162;86;76
2059;Mesas, Las;Cuenca;Castilla-La Mancha;2336;1188;1148
7337;Mesegar de Corneja;Ávila;Castilla y León;62;36;26
5551;Mesegar de Tajo;Toledo;Castilla-La Mancha;214;112;102
1967;Mesía;Coruña, A;Galicia;2530;1260;1270
5184;Mesones de Isuela;Zaragoza;Aragón;264;133;131
3705;Mestanza;Ciudad Real;Castilla-La Mancha;667;337;330
5040;Metauten;Navarra;Navarra;288;156;132
5373;Mezalocha;Zaragoza;Aragón;238;138;100
6851;Mezquita de Jarque;Teruel;Aragón;96;57;39
3097;Mezquita, A;Ourense;Galicia;1023;530;493
779;Miajadas;Cáceres;Extremadura;9607;4800;4807
7915;Mianos;Zaragoza;Aragón;30;17;13
4278;Micereces de Tera;Zamora;Castilla y León;457;233;224
7187;Micieces de Ojeda;Palencia;Castilla y León;73;41;32
4381;Miedes de Aragón;Zaragoza;Aragón;433;234;199
7395;Miedes de Atienza;Guadalajara;Castilla-La Mancha;59;37;22
1342;Miengo;Cantabria;Cantabria;4741;2407;2334
4568;Miera;Cantabria;Cantabria;380;198;182
191;Mieres;Asturias;Principado de Asturias;37959;18015;19944
4868;Mieres;Girona;Cataluña;318;160;158
7718;Mierla, La;Guadalajara;Castilla-La Mancha;41;28;13
5676;Mieza;Salamanca;Castilla y León;196;102;94
2666;Migjorn Gran, Es;Balears, Illes;Islas Baleares;1405;696;709
1325;Miguel Esteban;Toledo;Castilla-La Mancha;4856;2421;2435
6358;Migueláñez;Segovia;Castilla y León;131;71;60
529;Miguelturra;Ciudad Real;Castilla-La Mancha;15368;7742;7626
3631;Mijares;Ávila;Castilla y León;701;383;318
87;Mijas;Málaga;Andalucía;82742;41196;41546
5845;Milà, El;Tarragona;Cataluña;178;85;93
1641;Milagro;Navarra;Navarra;3416;1773;1643
4349;Milagros;Burgos;Castilla y León;439;240;199
6687;Milano, El;Salamanca;Castilla y León;106;62;44
6620;Millana;Guadalajara;Castilla-La Mancha;110;67;43
5305;Millanes;Cáceres;Extremadura;248;127;121
4733;Millares;Valencia/València;Comunidad Valenciana;345;183;162
5374;Millena;Alicante/Alacant;Comunidad Valenciana;237;127;110
5540;Milles de la Polvorosa;Zamora;Castilla y León;215;116;99
7183;Milmarcos;Guadalajara;Castilla-La Mancha;73;47;26
1523;Minas de Riotinto;Huelva;Andalucía;3848;1866;1982
2588;Minaya;Albacete;Castilla-La Mancha;1501;774;727
2127;Minglanilla;Cuenca;Castilla-La Mancha;2221;1137;1084
4540;Mingorría;Ávila;Castilla y León;387;204;183
1105;Miño;Coruña, A;Galicia;6200;3082;3118
6792;Miño de Medinaceli;Soria;Castilla y León;100;63;37
7648;Miño de San Esteban;Soria;Castilla y León;46;30;16
7941;Miñosa, La;Guadalajara;Castilla-La Mancha;28;19;9
3285;Mira;Cuenca;Castilla-La Mancha;905;462;443
3726;Mirabel;Cáceres;Extremadura;660;323;337
7069;Mirabueno;Guadalajara;Castilla-La Mancha;80;49;31
1114;Miraflores de la Sierra;Madrid;Comunidad de Madrid;6108;3133;2975
7442;Mirafuentes;Navarra;Navarra;57;28;29
2714;Miralcamp;Lleida;Cataluña;1351;677;674
7561;Miralrío;Guadalajara;Castilla-La Mancha;51;29;22
1917;Miramar;Valencia/València;Comunidad Valenciana;2634;1355;1279
6527;Mirambel;Teruel;Aragón;116;67;49
3368;Miranda de Arga;Navarra;Navarra;839;437;402
4379;Miranda de Azán;Salamanca;Castilla y León;433;227;206
206;Miranda de Ebro;Burgos;Castilla y León;35522;17469;18053
4493;Miranda del Castañar;Salamanca;Castilla y León;402;215;187
2789;Mirandilla;Badajoz;Extremadura;1267;641;626
7212;Miraveche;Burgos;Castilla y León;71;45;26
3653;Miravet;Tarragona;Cataluña;691;369;322
7895;Miravete de la Sierra;Teruel;Aragón;31;21;10
6439;Mirón, El;Ávila;Castilla y León;122;72;50
6750;Mironcillo;Ávila;Castilla y León;102;53;49
6856;Mirueña de los Infanzones;Ávila;Castilla y León;95;54;41
164;Mislata;Valencia/València;Comunidad Valenciana;43691;21246;22445
423;Moaña;Pontevedra;Galicia;19399;9431;9968
1318;Mocejón;Toledo;Castilla-La Mancha;4875;2456;2419
7642;Mochales;Guadalajara;Castilla-La Mancha;46;25;21
1580;Moclín;Granada;Andalucía;3651;1821;1830
2785;Moclinejo;Málaga;Andalucía;1271;657;614
3641;Modúbar de la Emparedada;Burgos;Castilla y León;695;376;319
2844;Moeche;Coruña, A;Galicia;1226;586;640
412;Mogán;Palmas, Las;Canarias;20072;10371;9701
5105;Mogarraz;Salamanca;Castilla y León;277;141;136
1423;Mogente/Moixent;Valencia/València;Comunidad Valenciana;4302;2155;2147
364;Moguer;Huelva;Andalucía;22088;11022;11066
3375;Mohedas de Granadilla;Cáceres;Extremadura;836;422;414
4494;Mohedas de la Jara;Toledo;Castilla-La Mancha;402;222;180
5889;Mohernando;Guadalajara;Castilla-La Mancha;173;85;88
1093;Moià;Barcelona;Cataluña;6267;3190;3077
1078;Mojácar;Almería;Andalucía;6403;3132;3271
1707;Mojados;Valladolid;Castilla y León;3210;1680;1530
829;Mojonera, La;Almería;Andalucía;9021;5075;3946
5239;Molacillos;Zamora;Castilla y León;257;139;118
836;Molar, El;Madrid;Comunidad de Madrid;8938;4557;4381
4989;Molar, El;Tarragona;Cataluña;297;158;139
1626;Molares, Los;Sevilla;Andalucía;3480;1775;1705
7479;Molezuelas de la Carballeda;Zamora;Castilla y León;56;31;25
1689;Molina de Aragón;Guadalajara;Castilla-La Mancha;3275;1636;1639
104;Molina de Segura;Murcia;Región de Murcia;71890;35862;36028
3305;Molinaseca;León;Castilla y León;884;488;396
3353;Molinicos;Albacete;Castilla-La Mancha;852;441;411
7753;Molinillo;Salamanca;Castilla y León;39;23;16
5363;Molinos;Teruel;Aragón;239;125;114
6002;Molinos de Duero;Soria;Castilla y León;162;89;73
1409;Molinos, Los;Madrid;Comunidad de Madrid;4389;2160;2229
302;Molins de Rei;Barcelona;Cataluña;25868;12612;13256
2583;Molledo;Cantabria;Cantabria;1504;746;758
552;Mollerussa;Lleida;Cataluña;14683;7543;7140
5725;Mollet de Peralada;Girona;Cataluña;189;96;93
143;Mollet del Vallès;Barcelona;Cataluña;51318;25222;26096
1273;Mollina;Málaga;Andalucía;5149;2585;2564
4772;Molló;Girona;Cataluña;337;162;175
6664;Molsosa, La;Lleida;Cataluña;107;53;54
1856;Molvízar;Granada;Andalucía;2794;1426;1368
3146;Mombeltrán;Ávila;Castilla y León;991;507;484
8026;Momblona;Soria;Castilla y León;22;15;7
4474;Mombuey;Zamora;Castilla y León;407;221;186
910;Monachil;Granada;Andalucía;7939;4094;3845
8099;Monasterio;Guadalajara;Castilla-La Mancha;14;6;8
7667;Monasterio de la Sierra;Burgos;Castilla y León;44;28;16
5840;Monasterio de Rodilla;Burgos;Castilla y León;178;101;77
7125;Monasterio de Vega;Valladolid;Castilla y León;77;41;36
368;Moncada;Valencia/València;Comunidad Valenciana;21935;10706;11229
7002;Moncalvillo;Burgos;Castilla y León;85;50;35
1064;Moncofa;Castellón/Castelló;Comunidad Valenciana;6525;3374;3151
1940;Monda;Málaga;Andalucía;2594;1336;1258
1401;Mondariz;Pontevedra;Galicia;4440;2199;2241
3758;Mondariz-Balneario;Pontevedra;Galicia;644;327;317
1912;Mondéjar;Guadalajara;Castilla-La Mancha;2645;1362;1283
1597;Mondoñedo;Lugo;Galicia;3568;1681;1887
4486;Monegrillo;Zaragoza;Aragón;405;227;178
7136;Monesma y Cajigar;Huesca;Aragón;76;43;33
1438;Monesterio;Badajoz;Extremadura;4226;2165;2061
6839;Moneva;Zaragoza;Aragón;97;56;41
3187;Monfarracinos;Zamora;Castilla y León;967;504;463
2295;Monfero;Coruña, A;Galicia;1932;994;938
4487;Monflorite-Lascasas;Huesca;Aragón;404;215;189
7230;Monforte de la Sierra;Salamanca;Castilla y León;70;38;32
447;Monforte de Lemos;Lugo;Galicia;18433;8751;9682
7274;Monforte de Moyuela;Teruel;Aragón;67;45;22
891;Monforte del Cid;Alicante/Alacant;Comunidad Valenciana;8165;4292;3873
3673;Monistrol de Calders;Barcelona;Cataluña;682;357;325
1761;Monistrol de Montserrat;Barcelona;Cataluña;3034;1551;1483
6892;Monleón;Salamanca;Castilla y León;93;53;40
5454;Monleras;Salamanca;Castilla y León;226;108;118
636;Monóvar/Monòver;Alicante/Alacant;Comunidad Valenciana;12167;6069;6098
5648;Monreal de Ariza;Zaragoza;Aragón;200;117;83
2010;Monreal del Campo;Teruel;Aragón;2434;1208;1226
7462;Monreal del Llano;Cuenca;Castilla-La Mancha;56;31;25
4216;Monreal/Elo;Navarra;Navarra;478;258;220
3209;Monroy;Cáceres;Extremadura;954;490;464
4760;Monroyo;Teruel;Aragón;340;200;140
6295;Monsagro;Salamanca;Castilla y León;137;74;63
7209;Monsalupe;Ávila;Castilla y León;71;36;35
6003;Mont-ral;Tarragona;Cataluña;162;94;68
2459;Mont-ras;Girona;Cataluña;1679;846;833
640;Mont-roig del Camp;Tarragona;Cataluña;12136;6260;5876
3277;Montagut i Oix;Girona;Cataluña;916;475;441
2835;Montalbán;Teruel;Aragón;1233;622;611
1388;Montalbán de Córdoba;Córdoba;Andalucía;4489;2219;2270
6735;Montalbanejo;Cuenca;Castilla-La Mancha;103;54;49
3760;Montalbo;Cuenca;Castilla-La Mancha;643;337;306
6827;Montalvos;Albacete;Castilla-La Mancha;97;52;45
3887;Montamarta;Zamora;Castilla y León;593;308;285
4620;Montán;Castellón/Castelló;Comunidad Valenciana;370;186;184
2452;Montánchez;Cáceres;Extremadura;1682;854;828
3946;Montanejos;Castellón/Castelló;Comunidad Valenciana;572;305;267
5561;Montanuy;Huesca;Aragón;212;123;89
8002;Montarrón;Guadalajara;Castilla-La Mancha;23;14;9
2488;Montaverner;Valencia/València;Comunidad Valenciana;1630;809;821
976;Montblanc;Tarragona;Cataluña;7364;3737;3627
1820;Montbrió del Camp;Tarragona;Cataluña;2890;1485;1405
201;Montcada i Reixac;Barcelona;Cataluña;36239;17901;18338
6299;Montclar;Barcelona;Cataluña;136;71;65
3010;Monteagudo;Navarra;Navarra;1092;545;547
6367;Monteagudo de las Salinas;Cuenca;Castilla-La Mancha;129;75;54
5776;Monteagudo de las Vicarías;Soria;Castilla y León;185;93;92
7513;Monteagudo del Castillo;Teruel;Aragón;54;30;24
6648;Montealegre de Campos;Valladolid;Castilla y León;109;66;43
2215;Montealegre del Castillo;Albacete;Castilla-La Mancha;2051;1043;1008
4065;Montearagón;Toledo;Castilla-La Mancha;525;279;246
3885;Montecorto;Málaga;Andalucía;593;317;276
3614;Montederramo;Ourense;Galicia;711;368;343
1214;Montefrío;Granada;Andalucía;5433;2754;2679
1166;Montehermoso;Cáceres;Extremadura;5739;2917;2822
3192;Montejaque;Málaga;Andalucía;964;478;486
2179;Montejícar;Granada;Andalucía;2113;1087;1026
5526;Montejo;Salamanca;Castilla y León;216;124;92
5853;Montejo de Arévalo;Segovia;Castilla y León;177;97;80
4687;Montejo de la Sierra;Madrid;Comunidad de Madrid;353;178;175
6199;Montejo de la Vega de la Serrezuela;Segovia;Castilla y León;146;87;59
6093;Montejo de Tiermes;Soria;Castilla y León;155;100;55
3931;Montellà i Martinet;Lleida;Cataluña;579;324;255
1007;Montellano;Sevilla;Andalucía;7056;3519;3537
1522;Montemayor;Córdoba;Andalucía;3855;1938;1917
3332;Montemayor de Pililla;Valladolid;Castilla y León;868;472;396
5192;Montemayor del Río;Salamanca;Castilla y León;263;141;122
2724;Montemolín;Badajoz;Extremadura;1343;646;697
7449;Montenegro de Cameros;Soria;Castilla y León;57;36;21
6069;Monterde;Zaragoza;Aragón;157;102;55
7323;Monterde de Albarracín;Teruel;Aragón;64;40;24
1969;Monterrei;Ourense;Galicia;2529;1293;1236
1588;Monterroso;Lugo;Galicia;3616;1812;1804
7365;Monterrubio;Segovia;Castilla y León;61;34;27
2726;Monterrubio de Armuña;Salamanca;Castilla y León;1343;703;640
7460;Monterrubio de la Demanda;Burgos;Castilla y León;56;35;21
2041;Monterrubio de la Serena;Badajoz;Extremadura;2372;1168;1204
6076;Monterrubio de la Sierra;Salamanca;Castilla y León;156;86;70
2914;Montesa;Valencia/València;Comunidad Valenciana;1164;585;579
4479;Montesclaros;Toledo;Castilla-La Mancha;406;217;189
1305;Montesinos, Los;Alicante/Alacant;Comunidad Valenciana;4968;2520;2448
3134;Montesquiu;Barcelona;Cataluña;998;501;497
3071;Montferrer i Castellbò;Lleida;Cataluña;1041;566;475
4544;Montferri;Tarragona;Cataluña;387;202;185
3805;Montgai;Lleida;Cataluña;625;329;296
645;Montgat;Barcelona;Cataluña;12041;5938;6103
2746;Montiel;Ciudad Real;Castilla-La Mancha;1315;689;626
527;Montijo;Badajoz;Extremadura;15457;7640;7817
349;Montilla;Córdoba;Andalucía;22859;11353;11506
2880;Montillana;Granada;Andalucía;1189;618;571
3918;Montitxelvo/Montichelvo;Valencia/València;Comunidad Valenciana;584;289;295
2426;Montizón;Jaén;Andalucía;1725;894;831
4255;Montmajor;Barcelona;Cataluña;464;231;233
6148;Montmaneu;Barcelona;Cataluña;150;83;67
2574;Montmell, El;Tarragona;Cataluña;1512;808;704
848;Montmeló;Barcelona;Cataluña;8755;4275;4480
4175;Montoliu de Lleida;Lleida;Cataluña;489;251;238
5837;Montoliu de Segarra;Lleida;Cataluña;179;100;79
6884;Montón;Zaragoza;Aragón;94;54;40
6159;Montorio;Burgos;Castilla y León;149;78;71
6789;Montornès de Segarra;Lleida;Cataluña;100;47;53
502;Montornès del Vallès;Barcelona;Cataluña;16393;8251;8142
797;Montoro;Córdoba;Andalucía;9364;4616;4748
1826;Montroi/Montroy;Valencia/València;Comunidad Valenciana;2867;1533;1334
4745;Montseny;Barcelona;Cataluña;342;179;163
914;Montserrat;Valencia/València;Comunidad Valenciana;7878;4053;3825
1811;Montuïri;Balears, Illes;Islas Baleares;2912;1465;1447
2280;Monturque;Córdoba;Andalucía;1958;967;991
474;Monzón;Huesca;Aragón;17236;8683;8553
3891;Monzón de Campos;Palencia;Castilla y León;592;309;283
773;Mora;Toledo;Castilla-La Mancha;9718;4875;4843
1174;Móra d'Ebre;Tarragona;Cataluña;5690;2845;2845
2550;Mora de Rubielos;Teruel;Aragón;1548;766;782
1735;Móra la Nova;Tarragona;Cataluña;3087;1541;1546
5902;Moradillo de Roa;Burgos;Castilla y León;171;93;78
1250;Moral de Calatrava;Ciudad Real;Castilla-La Mancha;5271;2672;2599
7604;Moral de Hornuez;Segovia;Castilla y León;49;29;20
6177;Moral de la Reina;Valladolid;Castilla y León;148;85;63
5240;Moral de Sayago;Zamora;Castilla y León;257;145;112
1719;Moraleda de Zafayona;Granada;Andalucía;3153;1596;1557
1034;Moraleja;Cáceres;Extremadura;6750;3341;3409
1275;Moraleja de Enmedio;Madrid;Comunidad de Madrid;5136;2548;2588
7713;Moraleja de las Panaderas;Valladolid;Castilla y León;42;23;19
7534;Moraleja de Matacabras;Ávila;Castilla y León;52;30;22
5063;Moraleja de Sayago;Zamora;Castilla y León;284;146;138
2435;Moraleja del Vino;Zamora;Castilla y León;1721;872;849
6292;Morales de Campos;Valladolid;Castilla y León;138;72;66
3936;Morales de Rey;Zamora;Castilla y León;577;290;287
3169;Morales de Toro;Zamora;Castilla y León;976;513;463
6005;Morales de Valverde;Zamora;Castilla y León;162;82;80
1796;Morales del Vino;Zamora;Castilla y León;2947;1537;1410
5311;Moralina;Zamora;Castilla y León;248;128;120
601;Moralzarzal;Madrid;Comunidad de Madrid;13026;6527;6499
1450;Moraña;Pontevedra;Galicia;4179;2024;2155
5256;Morasverdes;Salamanca;Castilla y León;254;134;120
3024;Morata de Jalón;Zaragoza;Aragón;1079;531;548
4963;Morata de Jiloca;Zaragoza;Aragón;302;172;130
935;Morata de Tajuña;Madrid;Comunidad de Madrid;7683;3836;3847
921;Moratalla;Murcia;Región de Murcia;7839;3978;3861
6736;Moratilla de los Meleros;Guadalajara;Castilla-La Mancha;103;57;46
7304;Moratinos;Palencia;Castilla y León;65;37;28
4614;Morcillo;Cáceres;Extremadura;371;171;200
1939;Morcín;Asturias;Principado de Asturias;2594;1303;1291
5486;Moreda de Álava/Moreda Araba;Araba/Álava;País Vasco;221;108;113
3852;Morelábor;Granada;Andalucía;607;329;278
1568;Morell, El;Tarragona;Cataluña;3704;1881;1823
2013;Morella;Castellón/Castelló;Comunidad Valenciana;2430;1192;1238
7767;Morenilla;Guadalajara;Castilla-La Mancha;38;23;15
6372;Morentin;Navarra;Navarra;129;62;67
6128;Morera de Montsant, La;Tarragona;Cataluña;152;85;67
3604;Morera, La;Badajoz;Extremadura;715;365;350
4754;Moreruela de los Infanzones;Zamora;Castilla y León;341;180;161
4892;Moreruela de Tábara;Zamora;Castilla y León;315;169;146
4848;Morés;Zaragoza;Aragón;323;172;151
4454;Morga;Bizkaia;País Vasco;410;219;191
1560;Moriles;Córdoba;Andalucía;3717;1866;1851
5400;Morille;Salamanca;Castilla y León;233;128;105
6863;Moríñigo;Salamanca;Castilla y León;95;53;42
4397;Moriscos;Salamanca;Castilla y León;429;234;195
5699;Morón de Almazán;Soria;Castilla y León;193;100;93
278;Morón de la Frontera;Sevilla;Andalucía;27627;13628;13999
7217;Moronta;Salamanca;Castilla y León;71;45;26
4743;Moros;Zaragoza;Aragón;343;178;165
540;Mos;Pontevedra;Galicia;15078;7453;7625
7514;Moscardón;Teruel;Aragón;54;30;24
4027;Mosqueruela;Teruel;Aragón;537;293;244
27;Móstoles;Madrid;Comunidad de Madrid;209184;101905;107279
7823;Mota de Altarejos;Cuenca;Castilla-La Mancha;34;22;12
1132;Mota del Cuervo;Cuenca;Castilla-La Mancha;5990;2993;2997
4701;Mota del Marqués;Valladolid;Castilla y León;351;186;165
1149;Motilla del Palancar;Cuenca;Castilla-La Mancha;5869;2908;2961
3948;Motilleja;Albacete;Castilla-La Mancha;571;307;264
129;Motril;Granada;Andalucía;58020;28522;29498
933;Moya;Palmas, Las;Canarias;7696;3913;3783
6279;Moya;Cuenca;Castilla-La Mancha;139;84;55
5091;Moyuela;Zaragoza;Aragón;280;156;124
4141;Mozárbez;Salamanca;Castilla y León;499;261;238
3287;Mozoncillo;Segovia;Castilla y León;902;492;410
6451;Mozota;Zaragoza;Aragón;122;61;61
3718;Mucientes;Valladolid;Castilla y León;662;336;326
6993;Mudá;Palencia;Castilla y León;86;47;39
6051;Mudarra, La;Valladolid;Castilla y León;158;80;78
6788;Muduex;Guadalajara;Castilla-La Mancha;100;54;46
2684;Muel;Zaragoza;Aragón;1378;701;677
1161;Muela, La;Zaragoza;Aragón;5784;3022;2762
5900;Muelas de los Caballeros;Zamora;Castilla y León;172;96;76
3785;Muelas del Pan;Zamora;Castilla y León;634;329;305
7154;Mues;Navarra;Navarra;75;43;32
4690;Muga de Sayago;Zamora;Castilla y León;353;172;181
1253;Mugardos;Coruña, A;Galicia;5245;2541;2704
2587;Muíños;Ourense;Galicia;1502;761;741
487;Mula;Murcia;Región de Murcia;16883;8671;8212
2326;Mundaka;Bizkaia;País Vasco;1852;898;954
4617;Munébrega;Zaragoza;Aragón;371;201;170
1636;Munera;Albacete;Castilla-La Mancha;3435;1763;1672
465;Mungia;Bizkaia;País Vasco;17691;8618;9073
3921;Muniesa;Teruel;Aragón;583;308;275
6539;Munilla;Rioja, La;La Rioja;115;64;51
4242;Munitibar-Arbatzegi Gerrikaitz;Bizkaia;País Vasco;468;257;211
3782;Muntanyola;Barcelona;Cataluña;634;321;313
4596;Muñana;Ávila;Castilla y León;375;201;174
6942;Muñico;Ávila;Castilla y León;89;47;42
4825;Muñogalindo;Ávila;Castilla y León;326;167;159
7278;Muñogrande;Ávila;Castilla y León;66;38;28
6487;Muñomer del Peco;Ávila;Castilla y León;118;64;54
4959;Muñopedro;Segovia;Castilla y León;303;165;138
6781;Muñopepe;Ávila;Castilla y León;100;56;44
6897;Muñosancho;Ávila;Castilla y León;92;44;48
7338;Muñotello;Ávila;Castilla y León;62;31;31
6209;Muñoveros;Segovia;Castilla y León;145;69;76
5462;Mura;Barcelona;Cataluña;224;122;102
3763;Muras;Lugo;Galicia;642;316;326
1458;Murchante;Navarra;Navarra;4154;2096;2058
7;Murcia;Murcia;Región de Murcia;453258;221543;231715
6826;Murero;Zaragoza;Aragón;98;58;40
4504;Murias de Paredes;León;Castilla y León;399;201;198
6435;Muriel;Valladolid;Castilla y León;123;65;58
7368;Muriel de la Fuente;Soria;Castilla y León;61;35;26
7006;Muriel Viejo;Soria;Castilla y León;85;56;29
4781;Murieta;Navarra;Navarra;335;177;158
5803;Murillo de Gállego;Zaragoza;Aragón;183;107;76
2490;Murillo de Río Leza;Rioja, La;La Rioja;1629;838;791
3710;Murillo el Cuende;Navarra;Navarra;665;343;322
3771;Murillo el Fruto;Navarra;Navarra;639;346;293
4234;Murla;Alicante/Alacant;Comunidad Valenciana;470;220;250
1004;Muro;Balears, Illes;Islas Baleares;7085;3574;3511
7345;Muro de Aguas;Rioja, La;La Rioja;62;36;26
802;Muro de Alcoy;Alicante/Alacant;Comunidad Valenciana;9324;4637;4687
7802;Muro en Cameros;Rioja, La;La Rioja;36;20;16
863;Muros;Coruña, A;Galicia;8556;4123;4433
2317;Muros de Nalón;Asturias;Principado de Asturias;1871;898;973
4247;Murtas;Granada;Andalucía;467;265;202
4931;Murueta;Bizkaia;País Vasco;308;155;153
5399;Muruzábal;Navarra;Navarra;233;101;132
1072;Museros;Valencia/València;Comunidad Valenciana;6458;3253;3205
953;Muskiz;Bizkaia;País Vasco;7507;3691;3816
5295;Mutiloa;Gipuzkoa;País Vasco;249;136;113
1235;Mutriku;Gipuzkoa;País Vasco;5333;2688;2645
312;Mutxamel;Alicante/Alacant;Comunidad Valenciana;25352;12662;12690
1354;Muxía;Coruña, A;Galicia;4657;2260;2397
2626;Muxika;Bizkaia;País Vasco;1465;761;704
5259;Nabarniz;Bizkaia;País Vasco;253;126;127
4151;Nacimiento;Almería;Andalucía;495;255;240
7806;Nafría de Ucero;Soria;Castilla y León;36;21;15
898;Nájera;Rioja, La;La Rioja;8045;3949;4096
3098;Nalda;Rioja, La;La Rioja;1023;555;468
6976;Nalec;Lleida;Cataluña;87;45;42
1343;Nambroca;Toledo;Castilla-La Mancha;4732;2439;2293
1054;Nàquera/Náquera;Valencia/València;Comunidad Valenciana;6577;3410;3167
7786;Narboneta;Cuenca;Castilla-La Mancha;37;19;18
182;Narón;Coruña, A;Galicia;39080;18904;20176
7197;Narrillos del Álamo;Ávila;Castilla y León;72;37;35
7609;Narrillos del Rebollar;Ávila;Castilla y León;48;27;21
7585;Narros;Soria;Castilla y León;50;28;22
5476;Narros de Matalayegua;Salamanca;Castilla y León;223;124;99
6731;Narros de Saldueña;Ávila;Castilla y León;103;61;42
6082;Narros del Castillo;Ávila;Castilla y León;155;85;70
7990;Narros del Puerto;Ávila;Castilla y León;24;12;12
2372;Naut Aran;Lleida;Cataluña;1803;935;868
1238;Nava;Asturias;Principado de Asturias;5321;2616;2705
3562;Nava de Arévalo;Ávila;Castilla y León;735;386;349
6878;Nava de Béjar;Salamanca;Castilla y León;94;54;40
6403;Nava de Francia;Salamanca;Castilla y León;126;68;58
1865;Nava de la Asunción;Segovia;Castilla y León;2774;1400;1374
4033;Nava de Ricomalillo, La;Toledo;Castilla-La Mancha;535;274;261
5446;Nava de Roa;Burgos;Castilla y León;227;121;106
3250;Nava de Santiago, La;Badajoz;Extremadura;932;471;461
6089;Nava de Sotrobal;Salamanca;Castilla y León;155;88;67
7012;Nava del Barco;Ávila;Castilla y León;84;45;39
2265;Nava del Rey;Valladolid;Castilla y León;1986;1018;968
5169;Nava, La;Huelva;Andalucía;266;137;129
6589;Navacarros;Salamanca;Castilla y León;112;57;55
6898;Navacepedilla de Corneja;Ávila;Castilla y León;92;46;46
1789;Navacerrada;Madrid;Comunidad de Madrid;2972;1493;1479
2261;Navaconcejo;Cáceres;Extremadura;1990;1005;985
7779;Navadijos;Ávila;Castilla y León;37;25;12
7552;Navaescurial;Ávila;Castilla y León;51;31;20
5082;Navafría;Segovia;Castilla y León;281;155;126
1589;Navahermosa;Toledo;Castilla-La Mancha;3609;1866;1743
4947;Navahondilla;Ávila;Castilla y León;304;178;126
3600;Navajas;Castellón/Castelló;Comunidad Valenciana;716;378;338
8115;Navajún;Rioja, La;La Rioja;10;8;2
5117;Naval;Huesca;Aragón;275;143;132
5313;Navalacruz;Ávila;Castilla y León;247;137;110
2638;Navalafuente;Madrid;Comunidad de Madrid;1449;744;705
1930;Navalagamella;Madrid;Comunidad de Madrid;2610;1350;1260
2267;Navalcán;Toledo;Castilla-La Mancha;1985;1044;941
262;Navalcarnero;Madrid;Comunidad de Madrid;29298;14585;14713
3490;Navaleno;Soria;Castilla y León;769;407;362
4835;Navales;Salamanca;Castilla y León;325;176;149
6740;Navalilla;Segovia;Castilla y León;103;56;47
3062;Navalmanzano;Segovia;Castilla y León;1049;546;503
4826;Navalmoral;Ávila;Castilla y León;326;175;151
7398;Navalmoral de Béjar;Salamanca;Castilla y León;59;27;32
481;Navalmoral de la Mata;Cáceres;Extremadura;17129;8252;8877
7515;Navalmoralejo;Toledo;Castilla-La Mancha;54;28;26
1975;Navalmorales, Los;Toledo;Castilla-La Mancha;2518;1327;1191
5451;Navalonguilla;Ávila;Castilla y León;226;114;112
4930;Navalosa;Ávila;Castilla y León;308;173;135
3488;Navalperal de Pinares;Ávila;Castilla y León;770;401;369
7040;Navalperal de Tormes;Ávila;Castilla y León;82;42;40
5435;Navalpino;Ciudad Real;Castilla-La Mancha;228;118;110
2183;Navalucillos, Los;Toledo;Castilla-La Mancha;2106;1080;1026
2283;Navaluenga;Ávila;Castilla y León;1954;970;984
4468;Navalvillar de Ibor;Cáceres;Extremadura;408;204;204
1404;Navalvillar de Pela;Badajoz;Extremadura;4424;2240;2184
7564;Navamorales;Salamanca;Castilla y León;51;32;19
3811;Navamorcuende;Toledo;Castilla-La Mancha;623;313;310
8083;Navaquesera;Ávila;Castilla y León;16;8;8
1135;Navarcles;Barcelona;Cataluña;5977;2914;3063
7778;Navardún;Zaragoza;Aragón;38;23;15
7528;Navares de Ayuso;Segovia;Castilla y León;53;27;26
6880;Navares de Enmedio;Segovia;Castilla y León;94;57;37
8008;Navares de las Cuevas;Segovia;Castilla y León;23;15;8
5635;Navaridas;Araba/Álava;País Vasco;200;112;88
4373;Navarredonda de Gredos;Ávila;Castilla y León;434;217;217
5926;Navarredonda de la Rinconada;Salamanca;Castilla y León;169;85;84
6371;Navarredonda y San Mamés;Madrid;Comunidad de Madrid;129;84;45
5892;Navarredondilla;Ávila;Castilla y León;172;87;85
1791;Navarrés;Valencia/València;Comunidad Valenciana;2968;1503;1465
1797;Navarrete;Rioja, La;La Rioja;2941;1490;1451
5203;Navarrevisca;Ávila;Castilla y León;261;146;115
1127;Navàs;Barcelona;Cataluña;6020;2998;3022
7841;Navas de Bureba;Burgos;Castilla y León;33;16;17
4977;Navas de Estena;Ciudad Real;Castilla-La Mancha;298;161;137
7956;Navas de Jadraque, Las;Guadalajara;Castilla-La Mancha;27;18;9
4088;Navas de Jorquera;Albacete;Castilla-La Mancha;517;266;251
2544;Navas de la Concepción, Las;Sevilla;Andalucía;1559;775;784
2730;Navas de Oro;Segovia;Castilla y León;1338;677;661
4521;Navas de Riofrío;Segovia;Castilla y León;394;185;209
4816;Navas de San Antonio;Segovia;Castilla y León;328;170;158
1379;Navas de San Juan;Jaén;Andalucía;4517;2260;2257
2763;Navas del Madroño;Cáceres;Extremadura;1292;647;645
1282;Navas del Marqués, Las;Ávila;Castilla y León;5119;2608;2511
1808;Navas del Rey;Madrid;Comunidad de Madrid;2918;1535;1383
6348;Navascués/Nabaskoze;Navarra;Navarra;132;80;52
4366;Navasfrías;Salamanca;Castilla y León;436;230;206
2679;Navata;Girona;Cataluña;1381;671;710
5395;Navatalgordo;Ávila;Castilla y León;233;133;100
7484;Navatejares;Ávila;Castilla y León;55;25;30
5086;Navès;Lleida;Cataluña;280;147;133
3773;Navezuelas;Cáceres;Extremadura;637;323;314
881;Navia;Asturias;Principado de Asturias;8380;4033;4347
3019;Navia de Suarna;Lugo;Galicia;1081;600;481
5819;Navianos de Valverde;Zamora;Castilla y León;182;104;78
7825;Nazar;Navarra;Navarra;34;20;14
7409;Nebreda;Burgos;Castilla y León;58;42;16
1286;Neda;Coruña, A;Galicia;5079;2464;2615
8074;Negredo;Guadalajara;Castilla-La Mancha;17;9;8
1026;Negreira;Coruña, A;Galicia;6827;3302;3525
6963;Negrilla de Palencia;Salamanca;Castilla y León;88;53;35
5534;Negueira de Muñiz;Lugo;Galicia;215;114;101
6099;Neila;Burgos;Castilla y León;154;89;65
7295;Neila de San Miguel;Ávila;Castilla y León;65;34;31
7569;Nepas;Soria;Castilla y León;51;36;15
381;Nerja;Málaga;Andalucía;21091;10410;10681
2873;Nerpio;Albacete;Castilla-La Mancha;1191;660;531
1256;Nerva;Huelva;Andalucía;5235;2517;2718
7021;Nestares;Rioja, La;La Rioja;84;46;38
3059;Nevada;Granada;Andalucía;1050;543;507
1527;Neves, As;Pontevedra;Galicia;3841;1862;1979
1470;Niebla;Huelva;Andalucía;4117;2074;2043
5183;Nieva;Segovia;Castilla y León;264;132;132
6935;Nieva de Cameros;Rioja, La;La Rioja;90;62;28
466;Nigrán;Pontevedra;Galicia;17675;8680;8995
2903;Nigüelas;Granada;Andalucía;1173;594;579
7352;Nigüella;Zaragoza;Aragón;62;38;24
5823;Niharra;Ávila;Castilla y León;180;104;76
247;Níjar;Almería;Andalucía;30663;17075;13588
3142;Nívar;Granada;Andalucía;994;519;475
883;Noáin (Valle de Elorz)/Noain (Elortzibar);Navarra;Navarra;8320;4185;4135
2273;Noalejo;Jaén;Andalucía;1970;996;974
1592;Noblejas;Toledo;Castilla-La Mancha;3585;1818;1767
3697;Noceda del Bierzo;León;Castilla y León;672;345;327
3314;Noez;Toledo;Castilla-La Mancha;878;446;432
3022;Nogais, As;Lugo;Galicia;1079;575;504
7722;Nogal de las Huertas;Palencia;Castilla y León;41;21;20
3742;Nogales;Badajoz;Extremadura;652;329;323
2257;Nogueira de Ramuín;Ourense;Galicia;1998;1020;978
6273;Noguera de Albarracín;Teruel;Aragón;140;81;59
8030;Nogueras;Teruel;Aragón;22;16;6
5521;Nogueruelas;Teruel;Aragón;217;123;94
563;Noia;Coruña, A;Galicia;14263;6839;7424
1952;Noja;Cantabria;Cantabria;2556;1274;1282
7450;Nolay;Soria;Castilla y León;57;31;26
3345;Nombela;Toledo;Castilla-La Mancha;858;452;406
7898;Nombrevilla;Zaragoza;Aragón;31;19;12
3199;Nonaspe;Zaragoza;Aragón;961;519;442
1266;Noreña;Asturias;Principado de Asturias;5179;2478;2701
6007;Nou de Berguedà, La;Barcelona;Cataluña;161;83;78
3865;Nou de Gaià, La;Tarragona;Cataluña;603;300;303
6073;Novales;Huesca;Aragón;156;75;81
3389;Novallas;Zaragoza;Aragón;830;440;390
307;Novelda;Alicante/Alacant;Comunidad Valenciana;25651;12770;12881
3371;Novelé/Novetlè;Valencia/València;Comunidad Valenciana;837;411;426
1815;Novés;Toledo;Castilla-La Mancha;2905;1482;1423
6077;Noviercas;Soria;Castilla y León;156;88;68
4040;Novillas;Zaragoza;Aragón;532;268;264
444;Nucia, la;Alicante/Alacant;Comunidad Valenciana;18603;9425;9178
4025;Nueno;Huesca;Aragón;537;295;242
1227;Nueva Carteya;Córdoba;Andalucía;5379;2732;2647
5089;Nueva Villa de las Torres;Valladolid;Castilla y León;280;162;118
4928;Nuévalos;Zaragoza;Aragón;310;173;137
1091;Nuevo Baztán;Madrid;Comunidad de Madrid;6276;3191;3085
3372;Nuez de Ebro;Zaragoza;Aragón;837;419;418
598;Nules;Castellón/Castelló;Comunidad Valenciana;13103;6549;6554
4162;Nulles;Tarragona;Cataluña;492;267;225
1315;Numancia de la Sagra;Toledo;Castilla-La Mancha;4902;2570;2332
6336;Nuño Gómez;Toledo;Castilla-La Mancha;133;76;57
2783;Nuñomoral;Cáceres;Extremadura;1272;676;596
3244;Obanos;Navarra;Navarra;935;467;468
2249;Obejo;Córdoba;Andalucía;2011;1048;963
7679;Obón;Teruel;Aragón;44;23;21
663;Ocaña;Toledo;Castilla-La Mancha;11597;5849;5748
8035;Ocentejo;Guadalajara;Castilla-La Mancha;21;15;6
4078;Ochagavía/Otsagabia;Navarra;Navarra;521;281;240
7107;Ochánduri;Rioja, La;La Rioja;78;47;31
7118;Oco;Navarra;Navarra;77;39;38
4967;Ocón;Rioja, La;La Rioja;301;184;117
5297;Odèn;Lleida;Cataluña;249;149;100
1583;Òdena;Barcelona;Cataluña;3643;1848;1795
4657;Odieta;Navarra;Navarra;362;202;160
5605;Odón;Teruel;Aragón;206;107;99
5124;Oencia;León;Castilla y León;274;161;113
5392;Ogassa;Girona;Cataluña;234;130;104
565;Ogíjares;Granada;Andalucía;14160;7008;7152
3928;Ohanes;Almería;Andalucía;580;292;288
1749;Oia;Pontevedra;Galicia;3053;1521;1532
741;Oiartzun;Gipuzkoa;País Vasco;10293;5081;5212
2437;Oímbra;Ourense;Galicia;1712;934;778
6373;Oiz;Navarra;Navarra;129;79;50
5814;Ojacastro;Rioja, La;La Rioja;182;109;73
1569;Ojén;Málaga;Andalucía;3702;1888;1814
4138;Ojós;Murcia;Región de Murcia;500;260;240
4666;Ojos Negros;Teruel;Aragón;360;198;162
7041;Ojos-Albos;Ávila;Castilla y León;82;50;32
2881;Okondo;Araba/Álava;País Vasco;1188;611;577
3212;Olaberria;Gipuzkoa;País Vasco;953;480;473
4582;Olaibar;Navarra;Navarra;378;220;158
2600;Olazti/Olazagutía;Navarra;Navarra;1489;753;736
5439;Olba;Teruel;Aragón;228;128;100
7738;Olea de Boedo;Palencia;Castilla y León;40;15;25
202;Oleiros;Coruña, A;Galicia;36075;17381;18694
7578;Olejua;Navarra;Navarra;50;27;23
1570;Olèrdola;Barcelona;Cataluña;3692;1900;1792
2367;Olesa de Bonesvalls;Barcelona;Cataluña;1810;949;861
337;Olesa de Montserrat;Barcelona;Cataluña;23904;11913;11991
2368;Oliana;Lleida;Cataluña;1810;906;904
913;Olías del Rey;Toledo;Castilla-La Mancha;7880;4043;3837
4700;Oliete;Teruel;Aragón;351;183;168
5665;Oliola;Lleida;Cataluña;197;106;91
1501;Olite/Erriberri;Navarra;Navarra;3946;2001;1945
3154;Olius;Lleida;Cataluña;986;527;459
316;Oliva;Valencia/València;Comunidad Valenciana;25101;12312;12789
1274;Oliva de la Frontera;Badajoz;Extremadura;5137;2571;2566
2423;Oliva de Mérida;Badajoz;Extremadura;1729;874;855
4954;Oliva de Plasencia;Cáceres;Extremadura;303;173;130
293;Oliva, La;Palmas, Las;Canarias;26580;13825;12755
7214;Olivar, El;Guadalajara;Castilla-La Mancha;71;41;30
795;Olivares;Sevilla;Andalucía;9394;4711;4683
4994;Olivares de Duero;Valladolid;Castilla y León;296;162;134
4831;Olivares de Júcar;Cuenca;Castilla-La Mancha;325;169;156
1536;Olivella;Barcelona;Cataluña;3799;1985;1814
651;Olivenza;Badajoz;Extremadura;11963;5967;5996
5022;Ollauri;Rioja, La;La Rioja;291;154;137
885;Olleria, l';Valencia/València;Comunidad Valenciana;8281;4132;4149
7284;Olmeda de Cobeta;Guadalajara;Castilla-La Mancha;66;36;30
8075;Olmeda de Jadraque, La;Guadalajara;Castilla-La Mancha;17;10;7
8045;Olmeda de la Cuesta;Cuenca;Castilla-La Mancha;20;11;9
4715;Olmeda de las Fuentes;Madrid;Comunidad de Madrid;348;185;163
6344;Olmeda del Rey;Cuenca;Castilla-La Mancha;132;67;65
6160;Olmedilla de Alarcón;Cuenca;Castilla-La Mancha;149;85;64
8091;Olmedilla de Eliz;Cuenca;Castilla-La Mancha;15;10;5
5835;Olmedillo de Roa;Burgos;Castilla y León;179;104;75
1584;Olmedo;Valladolid;Castilla y León;3643;1806;1837
6590;Olmedo de Camaces;Salamanca;Castilla y León;112;59;53
5507;Olmillos de Castro;Zamora;Castilla y León;219;118;101
7810;Olmillos de Muñó;Burgos;Castilla y León;35;20;15
5633;Olmos de Esgueva;Valladolid;Castilla y León;201;111;90
5667;Olmos de Ojeda;Palencia;Castilla y León;197;120;77
7548;Olmos de Peñafiel;Valladolid;Castilla y León;52;28;24
6472;Olmos, Los;Teruel;Aragón;120;65;55
2389;Olocau;Valencia/València;Comunidad Valenciana;1771;931;840
6478;Olocau del Rey;Castellón/Castelló;Comunidad Valenciana;119;65;54
4031;Olombrada;Segovia;Castilla y León;536;288;248
5619;Olóriz/Oloritz;Navarra;Navarra;203;115;88
2868;Olost;Barcelona;Cataluña;1198;588;610
209;Olot;Girona;Cataluña;35228;17569;17659
5948;Oluges, Les;Lleida;Cataluña;167;88;79
5669;Olula de Castro;Almería;Andalucía;196;109;87
1103;Olula del Río;Almería;Andalucía;6210;3182;3028
3350;Olvan;Barcelona;Cataluña;854;416;438
1579;Ólvega;Soria;Castilla y León;3656;1902;1754
7490;Olvena;Huesca;Aragón;55;29;26
893;Olvera;Cádiz;Andalucía;8113;3971;4142
6729;Olvés;Zaragoza;Aragón;104;62;42
5170;Omañas, Las;León;Castilla y León;266;144;122
5570;Omellons, Els;Lleida;Cataluña;211;111;100
6354;Omells de na Gaia, Els;Lleida;Cataluña;131;72;59
7159;Oncala;Soria;Castilla y León;75;43;32
317;Onda;Castellón/Castelló;Comunidad Valenciana;24859;12484;12375
1023;Ondara;Alicante/Alacant;Comunidad Valenciana;6894;3460;3434
876;Ondarroa;Bizkaia;País Vasco;8400;4209;4191
952;Onil;Alicante/Alacant;Comunidad Valenciana;7507;3757;3750
3542;Onís;Asturias;Principado de Asturias;743;402;341
1410;Ontígola;Toledo;Castilla-La Mancha;4387;2336;2051
207;Ontinyent;Valencia/València;Comunidad Valenciana;35347;17441;17906
4087;Ontiñena;Huesca;Aragón;518;261;257
2262;Ontur;Albacete;Castilla-La Mancha;1987;1009;978
2342;Onzonilla;León;Castilla y León;1835;940;895
3107;Oña;Burgos;Castilla y León;1017;540;477
675;Oñati;Gipuzkoa;País Vasco;11380;5617;5763
7521;Oquillas;Burgos;Castilla y León;53;31;22
2148;Orba;Alicante/Alacant;Comunidad Valenciana;2174;1074;1100
5652;Orbada, La;Salamanca;Castilla y León;199;104;95
5680;Orbaizeta;Navarra;Navarra;195;97;98
4775;Orbaneja Riopico;Burgos;Castilla y León;336;181;155
7849;Orbara;Navarra;Navarra;33;17;16
7146;Orbita;Ávila;Castilla y León;75;39;36
7427;Orcajo;Zaragoza;Aragón;58;36;22
2879;Orce;Granada;Andalucía;1190;605;585
2365;Orcera;Jaén;Andalucía;1811;914;897
615;Ordes;Coruña, A;Galicia;12674;6190;6484
7922;Ordial, El;Guadalajara;Castilla-La Mancha;29;17;12
4615;Ordis;Girona;Cataluña;371;199;172
729;Ordizia;Gipuzkoa;País Vasco;10394;5151;5243
5829;Orea;Guadalajara;Castilla-La Mancha;180;107;73
7422;Orejana;Segovia;Castilla y León;58;35;23
5433;Orellana de la Sierra;Badajoz;Extremadura;228;113;115
1896;Orellana la Vieja;Badajoz;Extremadura;2693;1389;1304
5511;Orendain;Gipuzkoa;País Vasco;218;112;106
6557;Orera;Zaragoza;Aragón;114;60;54
6558;Orés;Zaragoza;Aragón;114;69;45
6454;Orexa;Gipuzkoa;País Vasco;121;67;54
3467;Organyà;Lleida;Cataluña;784;388;396
1933;Orgaz;Toledo;Castilla-La Mancha;2602;1293;1309
1169;Órgiva;Granada;Andalucía;5725;2872;2853
2115;Oria;Almería;Andalucía;2249;1170;1079
98;Orihuela;Alicante/Alacant;Comunidad Valenciana;77414;38360;39054
4261;Orihuela del Tremedal;Teruel;Aragón;463;251;212
1126;Orio;Gipuzkoa;País Vasco;6022;3020;3002
4889;Orís;Barcelona;Cataluña;315;159;156
7085;Orísoain;Navarra;Navarra;79;43;36
4008;Oristà;Barcelona;Cataluña;541;274;267
1481;Orkoien;Navarra;Navarra;4057;2057;2000
2780;Ormaiztegi;Gipuzkoa;País Vasco;1276;641;635
7628;Oronz/Orontze;Navarra;Navarra;47;24;23
1907;Oropesa;Toledo;Castilla-La Mancha;2662;1296;1366
823;Oropesa del Mar/Orpesa;Castellón/Castelló;Comunidad Valenciana;9076;4660;4416
955;Oroso;Coruña, A;Galicia;7500;3708;3792
168;Orotava, La;Santa Cruz de Tenerife;Canarias;42029;20564;21465
6196;Oroz-Betelu/Orotz-Betelu;Navarra;Navarra;146;85;61
1916;Orozko;Bizkaia;País Vasco;2636;1294;1342
6180;Orpí;Barcelona;Cataluña;147;80;67
8019;Orreaga/Roncesvalles;Navarra;Navarra;22;12;10
6413;Orrios;Teruel;Aragón;125;67;58
3551;Òrrius;Barcelona;Cataluña;739;381;358
5427;Ortigosa de Cameros;Rioja, La;La Rioja;229;138;91
7495;Ortigosa de Pestaño;Segovia;Castilla y León;55;29;26
3972;Ortigosa del Monte;Segovia;Castilla y León;561;299;262
1178;Ortigueira;Coruña, A;Galicia;5671;2708;2963
877;Ortuella;Bizkaia;País Vasco;8395;4091;4304
2821;Orusco de Tajuña;Madrid;Comunidad de Madrid;1244;637;607
3556;Orxeta;Alicante/Alacant;Comunidad Valenciana;736;379;357
3143;Os de Balaguer;Lleida;Cataluña;994;507;487
4210;Osa de la Vega;Cuenca;Castilla-La Mancha;479;249;230
7533;Oseja;Zaragoza;Aragón;53;33;20
5408;Oseja de Sajambre;León;Castilla y León;232;135;97
4548;Osera de Ebro;Zaragoza;Aragón;386;193;193
6019;Oso, El;Ávila;Castilla y León;160;92;68
4400;Osor;Girona;Cataluña;428;227;201
7468;Osornillo;Palencia;Castilla y León;56;30;26
2862;Osorno la Mayor;Palencia;Castilla y León;1205;638;567
2075;Ossa de Montiel;Albacete;Castilla-La Mancha;2307;1154;1153
3676;Osso de Cinca;Huesca;Aragón;681;376;305
5614;Ossó de Sió;Lleida;Cataluña;204;98;106
469;Osuna;Sevilla;Andalucía;17560;8741;8819
3275;Oteiza;Navarra;Navarra;918;489;429
4802;Otero;Toledo;Castilla-La Mancha;331;176;155
6096;Otero de Bodas;Zamora;Castilla y León;155;85;70
3203;Otero de Herreros;Segovia;Castilla y León;959;486;473
3085;Otívar;Granada;Andalucía;1034;524;510
4376;Otos;Valencia/València;Comunidad Valenciana;434;219;215
2749;Otxandio;Bizkaia;País Vasco;1314;670;644
59;Ourense;Ourense;Galicia;105233;47695;57538
3106;Ourol;Lugo;Galicia;1018;521;497
1272;Outeiro de Rei;Lugo;Galicia;5151;2655;2496
1089;Outes;Coruña, A;Galicia;6282;3018;3264
23;Oviedo;Asturias;Principado de Asturias;219686;101732;117954
1653;Oyón-Oion;Araba/Álava;País Vasco;3386;1708;1678
1284;Oza-Cesuras;Coruña, A;Galicia;5101;2562;2539
3262;Pacs del Penedès;Barcelona;Cataluña;922;469;453
2032;Paderne;Coruña, A;Galicia;2394;1173;1221
2677;Paderne de Allariz;Ourense;Galicia;1384;693;691
5139;Padiernos;Ávila;Castilla y León;271;149;122
7149;Padilla de Abajo;Burgos;Castilla y León;75;45;30
7150;Padilla de Arriba;Burgos;Castilla y León;75;47;28
2413;Padrenda;Ourense;Galicia;1748;860;888
880;Padrón;Coruña, A;Galicia;8384;4030;4354
7573;Padrones de Bureba;Burgos;Castilla y León;50;23;27
875;Padul;Granada;Andalucía;8420;4223;4197
4450;Padules;Almería;Andalucía;410;208;202
300;Paiporta;Valencia/València;Comunidad Valenciana;26088;12884;13204
380;Pájara;Palmas, Las;Canarias;21093;10977;10116
7983;Pajarejos;Segovia;Castilla y León;25;13;12
6158;Pajares de Adaja;Ávila;Castilla y León;149;81;68
6625;Pajares de la Laguna;Salamanca;Castilla y León;110;59;51
4893;Pajares de la Lampreana;Zamora;Castilla y León;315;159;156
5171;Pajares de los Oteros;León;Castilla y León;266;162;104
7045;Pajarón;Cuenca;Castilla-La Mancha;82;39;43
7299;Pajaroncillo;Cuenca;Castilla-La Mancha;65;40;25
4499;Palacios de Goda;Ávila;Castilla y León;400;207;193
3583;Palacios de la Sierra;Burgos;Castilla y León;725;368;357
4577;Palacios de la Valduerna;León;Castilla y León;379;183;196
7976;Palacios de Riopisuerga;Burgos;Castilla y León;25;12;13
5460;Palacios de Sanabria;Zamora;Castilla y León;225;112;113
5962;Palacios del Arzobispo;Salamanca;Castilla y León;165;80;85
5210;Palacios del Pan;Zamora;Castilla y León;261;134;127
3232;Palacios del Sil;León;Castilla y León;941;501;440
187;Palacios y Villafranca, Los;Sevilla;Andalucía;38354;19244;19110
4782;Palaciosrubios;Salamanca;Castilla y León;335;174;161
794;Palafolls;Barcelona;Cataluña;9405;4690;4715
347;Palafrugell;Girona;Cataluña;22974;11377;11597
461;Palamós;Girona;Cataluña;17910;8766;9144
7902;Palanques;Castellón/Castelló;Comunidad Valenciana;30;18;12
1650;Palas de Rei;Lugo;Galicia;3388;1712;1676
2151;Palau d'Anglesola, El;Lleida;Cataluña;2166;1061;1105
6915;Palau de Santa Eulàlia;Girona;Cataluña;91;52;39
4925;Palau-sator;Girona;Cataluña;310;166;144
2609;Palau-saverdera;Girona;Cataluña;1476;741;735
551;Palau-solità i Plegamans;Barcelona;Cataluña;14771;7246;7525
5712;Palazuelo de Vedija;Valladolid;Castilla y León;191;102;89
1217;Palazuelos de Eresma;Segovia;Castilla y León;5416;2801;2615
7066;Palazuelos de la Sierra;Burgos;Castilla y León;80;47;33
7522;Palazuelos de Muñó;Burgos;Castilla y León;53;30;23
93;Palencia;Palencia;Castilla y León;78412;36990;41422
6104;Palencia de Negrilla;Salamanca;Castilla y León;154;91;63
2605;Palenciana;Córdoba;Andalucía;1478;748;730
5604;Palenzuela;Palencia;Castilla y León;206;116;90
1337;Pallaresos, Els;Tarragona;Cataluña;4777;2404;2373
670;Pallejà;Barcelona;Cataluña;11508;5728;5780
8;Palma ;Balears, Illes;Islas Baleares;416065;203195;212870
4759;Palma d'Ebre, La;Tarragona;Cataluña;340;166;174
1795;Palma de Cervelló, La;Barcelona;Cataluña;2954;1460;1494
2487;Palma de Gandía;Valencia/València;Comunidad Valenciana;1631;843;788
710;Palma del Condado, La;Huelva;Andalucía;10761;5361;5400
382;Palma del Río;Córdoba;Andalucía;21064;10456;10608
7719;Pálmaces de Jadraque;Guadalajara;Castilla-La Mancha;41;26;15
2057;Palmar de Troya, El;Sevilla;Andalucía;2340;1165;1175
9;Palmas de Gran Canaria, Las;Palmas, Las;Canarias;379925;183417;196508
3096;Palmera;Valencia/València;Comunidad Valenciana;1024;523;501
7958;Palo;Huesca;Aragón;27;14;13
4286;Palol de Revardit;Girona;Cataluña;455;228;227
5939;Palomar de Arroyos;Teruel;Aragón;168;99;69
3894;Palomar, el;Valencia/València;Comunidad Valenciana;590;297;293
3867;Palomares del Campo;Cuenca;Castilla-La Mancha;602;308;294
847;Palomares del Río;Sevilla;Andalucía;8767;4395;4372
3681;Palomas;Badajoz;Extremadura;678;341;337
3177;Palomeque;Toledo;Castilla-La Mancha;971;522;449
5905;Palomera;Cuenca;Castilla-La Mancha;171;85;86
4476;Palomero;Cáceres;Extremadura;406;215;191
680;Palos de la Frontera;Huelva;Andalucía;11289;5737;5552
2025;Pals;Girona;Cataluña;2411;1222;1189
4852;Pampaneira;Granada;Andalucía;321;156;165
5021;Pampliega;Burgos;Castilla y León;291;156;135
29;Pamplona/Iruña;Navarra;Navarra;201653;95316;106337
4374;Pancorbo;Burgos;Castilla y León;434;235;199
6570;Pancrudo;Teruel;Aragón;113;65;48
3850;Paniza;Zaragoza;Aragón;609;327;282
3465;Panticosa;Huesca;Aragón;784;409;375
1676;Pantoja;Toledo;Castilla-La Mancha;3317;1660;1657
1960;Pantón;Lugo;Galicia;2542;1246;1296
5452;Papatrigo;Ávila;Castilla y León;226;113;113
1460;Papiol, El;Barcelona;Cataluña;4145;2052;2093
6872;Paracuellos;Cuenca;Castilla-La Mancha;94;50;44
313;Paracuellos de Jarama;Madrid;Comunidad de Madrid;25269;12703;12566
3892;Paracuellos de Jiloca;Zaragoza;Aragón;592;314;278
6237;Paracuellos de la Ribera;Zaragoza;Aragón;143;73;70
5286;Parada de Arriba;Salamanca;Castilla y León;251;129;122
5278;Parada de Rubiales;Salamanca;Castilla y León;252;132;120
4023;Parada de Sil;Ourense;Galicia;538;287;251
1022;Paradas;Sevilla;Andalucía;6908;3430;3478
2387;Paradela;Lugo;Galicia;1779;885;894
4512;Paradinas de San Juan;Salamanca;Castilla y León;396;232;164
6399;Páramo de Boedo;Palencia;Castilla y León;126;72;54
2801;Páramo del Sil;León;Castilla y León;1259;646;613
2699;Páramo, O;Lugo;Galicia;1366;681;685
5284;Parauta;Málaga;Andalucía;251;126;125
3257;Parcent;Alicante/Alacant;Comunidad Valenciana;929;446;483
6505;Pardilla;Burgos;Castilla y León;117;70;47
5995;Pardines;Girona;Cataluña;162;89;73
7685;Pardos;Guadalajara;Castilla-La Mancha;43;24;19
7282;Paredes;Cuenca;Castilla-La Mancha;66;37;29
6609;Paredes de Escalona;Toledo;Castilla-La Mancha;111;54;57
2309;Paredes de Nava;Palencia;Castilla y León;1885;969;916
8054;Paredes de Sigüenza;Guadalajara;Castilla-La Mancha;19;9;10
4522;Pareja;Guadalajara;Castilla-La Mancha;393;235;158
433;Parets del Vallès;Barcelona;Cataluña;19082;9541;9541
51;Parla;Madrid;Comunidad de Madrid;130124;64802;65322
4519;Parlavà;Girona;Cataluña;394;199;195
7844;Parra de las Vegas, La;Cuenca;Castilla-La Mancha;33;23;10
2720;Parra, La;Badajoz;Extremadura;1346;699;647
7257;Parral, El;Ávila;Castilla y León;67;36;31
7497;Parras de Castellote, Las;Teruel;Aragón;55;31;24
1234;Parres;Asturias;Principado de Asturias;5336;2588;2748
4208;Parrilla, La;Valladolid;Castilla y León;480;241;239
4694;Parrillas;Toledo;Castilla-La Mancha;352;187;165
2987;Partaloa;Almería;Andalucía;1110;564;546
6987;Partido de la Sierra en Tobalina;Burgos;Castilla y León;86;52;34
508;Pasaia;Gipuzkoa;País Vasco;16156;7794;8362
3794;Pasarón de la Vera;Cáceres;Extremadura;632;304;328
7651;Pascualcobo;Ávila;Castilla y León;45;29;16
938;Paso, El;Santa Cruz de Tenerife;Canarias;7622;3795;3827
5981;Passanant i Belltall;Tarragona;Cataluña;163;95;68
7399;Pastores;Salamanca;Castilla y León;59;36;23
1775;Pastoriza, A;Lugo;Galicia;3002;1513;1489
3358;Pastrana;Guadalajara;Castilla-La Mancha;850;435;415
2761;Pastriz;Zaragoza;Aragón;1297;620;677
106;Paterna;Valencia/València;Comunidad Valenciana;70195;34697;35498
1208;Paterna de Rivera;Cádiz;Andalucía;5470;2820;2650
1618;Paterna del Campo;Huelva;Andalucía;3509;1784;1725
4712;Paterna del Madera;Albacete;Castilla-La Mancha;348;190;158
4613;Paterna del Río;Almería;Andalucía;371;215;156
4012;Patones;Madrid;Comunidad de Madrid;541;254;287
3973;Pau;Girona;Cataluña;560;285;275
3984;Paüls;Tarragona;Cataluña;556;277;279
7356;Pavías;Castellón/Castelló;Comunidad Valenciana;61;39;22
2922;Paymogo;Huelva;Andalucía;1159;583;576
7266;Payo de Ojeda;Palencia;Castilla y León;67;39;28
4767;Payo, El;Salamanca;Castilla y León;338;163;175
1777;Pazos de Borbén;Pontevedra;Galicia;2999;1471;1528
7909;Pazuengos;Rioja, La;La Rioja;30;23;7
1251;Peal de Becerro;Jaén;Andalucía;5266;2602;2664
1486;Pechina;Almería;Andalucía;4037;2043;1994
2969;Pedernoso, El;Cuenca;Castilla-La Mancha;1124;561;563
3131;Pedrafita do Cebreiro;Lugo;Galicia;1001;545;456
2946;Pedraja de Portillo, La;Valladolid;Castilla y León;1139;587;552
1669;Pedrajas de San Esteban;Valladolid;Castilla y León;3327;1703;1624
1862;Pedralba;Valencia/València;Comunidad Valenciana;2778;1453;1325
5380;Pedralba de la Pradería;Zamora;Castilla y León;237;131;106
4737;Pedraza;Segovia;Castilla y León;344;196;148
5384;Pedraza de Alba;Salamanca;Castilla y León;235;124;111
7050;Pedraza de Campos;Palencia;Castilla y León;82;41;41
7173;Pedregal, El;Guadalajara;Castilla-La Mancha;74;47;27
931;Pedreguer;Alicante/Alacant;Comunidad Valenciana;7699;3809;3890
1262;Pedrera;Sevilla;Andalucía;5194;2576;2618
5656;Pedret i Marzà;Girona;Cataluña;198;101;97
1145;Pedrezuela;Madrid;Comunidad de Madrid;5892;2936;2956
1840;Pedro Abad;Córdoba;Andalucía;2837;1435;1402
3410;Pedro Bernardo;Ávila;Castilla y León;817;432;385
2992;Pedro Martínez;Granada;Andalucía;1107;539;568
984;Pedro Muñoz;Ciudad Real;Castilla-La Mancha;7293;3650;3643
6320;Pedro-Rodríguez;Ávila;Castilla y León;134;71;63
2570;Pedroche;Córdoba;Andalucía;1516;738;778
1598;Pedrola;Zaragoza;Aragón;3568;1863;1705
1048;Pedroñeras, Las;Cuenca;Castilla-La Mancha;6638;3406;3232
4186;Pedrosa de Duero;Burgos;Castilla y León;484;276;208
4970;Pedrosa de la Vega;Palencia;Castilla y León;300;168;132
5349;Pedrosa de Río Úrbel;Burgos;Castilla y León;240;141;99
6943;Pedrosa del Páramo;Burgos;Castilla y León;89;53;36
5870;Pedrosa del Príncipe;Burgos;Castilla y León;175;95;80
5940;Pedrosa del Rey;Valladolid;Castilla y León;168;96;72
6983;Pedrosas, Las;Zaragoza;Aragón;87;44;43
6306;Pedrosillo de Alba;Salamanca;Castilla y León;136;81;55
4705;Pedrosillo de los Aires;Salamanca;Castilla y León;350;198;152
6421;Pedrosillo el Ralo;Salamanca;Castilla y León;124;66;58
7176;Pedroso;Rioja, La;La Rioja;74;51;23
7067;Pedroso de Acim;Cáceres;Extremadura;80;43;37
5549;Pedroso de la Armuña, El;Salamanca;Castilla y León;214;112;102
2244;Pedroso, El;Sevilla;Andalucía;2018;996;1022
1807;Pegalajar;Jaén;Andalucía;2919;1470;1449
747;Pego;Alicante/Alacant;Comunidad Valenciana;10128;5057;5071
4995;Pego, El;Zamora;Castilla y León;296;150;146
5135;Peguerinos;Ávila;Castilla y León;272;155;117
2877;Pelabravo;Salamanca;Castilla y León;1191;633;558
4920;Pelahustán;Toledo;Castilla-La Mancha;311;176;135
5937;Pelarrodríguez;Salamanca;Castilla y León;168;102;66
7061;Pelayos;Salamanca;Castilla y León;81;49;32
1935;Pelayos de la Presa;Madrid;Comunidad de Madrid;2596;1316;1280
7660;Pelayos del Arroyo;Segovia;Castilla y León;45;27;18
5174;Peleagonzalo;Zamora;Castilla y León;266;135;131
5072;Peleas de Abajo;Zamora;Castilla y León;283;132;151
674;Peligros;Granada;Andalucía;11394;5642;5752
2162;Penagos;Cantabria;Cantabria;2142;1078;1064
5014;Penàguila;Alicante/Alacant;Comunidad Valenciana;292;152;140
4298;Penelles;Lleida;Cataluña;452;262;190
940;Peníscola/Peñíscola;Castellón/Castelló;Comunidad Valenciana;7612;3849;3763
6903;Peña, La;Salamanca;Castilla y León;92;44;48
6283;Peñacaballera;Salamanca;Castilla y León;139;70;69
5202;Peñacerrada-Urizaharra;Araba/Álava;País Vasco;261;152;109
1295;Peñafiel;Valladolid;Castilla y León;5037;2522;2515
1578;Peñaflor;Sevilla;Andalucía;3656;1845;1811
4990;Peñaflor de Hornija;Valladolid;Castilla y León;297;170;127
3844;Peñalba;Huesca;Aragón;611;314;297
6751;Peñalba de Ávila;Ávila;Castilla y León;102;55;47
7184;Peñalén;Guadalajara;Castilla-La Mancha;73;43;30
3272;Peñalsordo;Badajoz;Extremadura;918;439;479
6212;Peñalver;Guadalajara;Castilla-La Mancha;144;94;50
4098;Peñamellera Alta;Asturias;Principado de Asturias;514;271;243
2843;Peñamellera Baja;Asturias;Principado de Asturias;1226;606;620
4688;Peñaparda;Salamanca;Castilla y León;353;176;177
1094;Peñaranda de Bracamonte;Salamanca;Castilla y León;6260;3076;3184
4053;Peñaranda de Duero;Burgos;Castilla y León;528;263;265
5816;Peñarandilla;Salamanca;Castilla y León;182;99;83
4355;Peñarroya de Tastavins;Teruel;Aragón;439;241;198
713;Peñarroya-Pueblonuevo;Córdoba;Andalucía;10695;5180;5515
4864;Peñarrubia;Cantabria;Cantabria;319;172;147
5308;Peñas de Riglos, Las;Huesca;Aragón;248;158;90
2668;Peñas de San Pedro;Albacete;Castilla-La Mancha;1399;817;582
4783;Peñascosa;Albacete;Castilla-La Mancha;334;184;150
4551;Peñausende;Zamora;Castilla y León;385;194;191
1748;Pepino;Toledo;Castilla-La Mancha;3055;1564;1491
6364;Peque;Zamora;Castilla y León;130;56;74
4327;Pera, La;Girona;Cataluña;446;221;225
7124;Peracense;Teruel;Aragón;77;42;35
4514;Perafita;Barcelona;Cataluña;395;202;193
2799;Perafort;Tarragona;Cataluña;1261;654;607
5921;Peral de Arlanza;Burgos;Castilla y León;169;89;80
3795;Peral, El;Cuenca;Castilla-La Mancha;632;353;279
2329;Peralada;Girona;Cataluña;1850;906;944
2694;Peraleda de la Mata;Cáceres;Extremadura;1369;697;672
4923;Peraleda de San Román;Cáceres;Extremadura;310;162;148
4100;Peraleda del Zaucejo;Badajoz;Extremadura;513;259;254
6833;Peraleja, La;Cuenca;Castilla-La Mancha;97;60;37
7092;Peralejos;Teruel;Aragón;79;47;32
5971;Peralejos de Abajo;Salamanca;Castilla y León;164;86;78
7773;Peralejos de Arriba;Salamanca;Castilla y León;38;25;13
6225;Peralejos de las Truchas;Guadalajara;Castilla-La Mancha;143;76;67
6978;Perales;Palencia;Castilla y León;87;49;38
1801;Perales de Tajuña;Madrid;Comunidad de Madrid;2935;1480;1455
5431;Perales del Alfambra;Teruel;Aragón;229;123;106
3215;Perales del Puerto;Cáceres;Extremadura;952;480;472
3982;Peralta de Alcofea;Huesca;Aragón;556;291;265
5579;Peralta de Calasanz;Huesca;Aragón;210;122;88
1142;Peralta/Azkoien;Navarra;Navarra;5893;2979;2914
5675;Peraltilla;Huesca;Aragón;196;98;98
7657;Peralveche;Guadalajara;Castilla-La Mancha;45;29;16
4722;Peramola;Lleida;Cataluña;347;177;170
4969;Peranzanes;León;Castilla y León;300;177;123
6602;Perarrúa;Huesca;Aragón;111;59;52
3700;Perdigón, El;Zamora;Castilla y León;671;354;317
3947;Perdiguera;Zaragoza;Aragón;572;305;267
1092;Pereiro de Aguiar, O;Ourense;Galicia;6275;3211;3064
1866;Perelló, El;Tarragona;Cataluña;2770;1421;1349
4732;Pereña de la Ribera;Salamanca;Castilla y León;345;187;158
4049;Pereruela;Zamora;Castilla y León;530;285;245
1754;Periana;Málaga;Andalucía;3048;1602;1446
6017;Perilla de Castro;Zamora;Castilla y León;161;83;78
4858;Pernía, La;Palencia;Castilla y León;320;189;131
6497;Peromingo;Salamanca;Castilla y León;118;55;63
8086;Perosillo;Segovia;Castilla y León;16;12;4
2360;Peroxa, A;Ourense;Galicia;1819;897;922
6564;Pertusa;Huesca;Aragón;113;65;48
5016;Pesaguero;Cantabria;Cantabria;292;169;123
6169;Pescueza;Cáceres;Extremadura;148;66;82
3084;Pesga, La;Cáceres;Extremadura;1034;543;491
6179;Pesoz;Asturias;Principado de Asturias;147;82;65
7100;Pesquera;Cantabria;Cantabria;78;47;31
4320;Pesquera de Duero;Valladolid;Castilla y León;448;243;205
5532;Pesquera, La;Cuenca;Castilla-La Mancha;215;119;96
7886;Petilla de Aragón;Navarra;Navarra;31;17;14
3339;Petín;Ourense;Galicia;861;420;441
1828;Petra;Balears, Illes;Islas Baleares;2860;1419;1441
216;Petrer;Alicante/Alacant;Comunidad Valenciana;34276;17039;17237
3136;Petrés;Valencia/València;Comunidad Valenciana;997;504;493
3650;Pétrola;Albacete;Castilla-La Mancha;692;350;342
2894;Peza, La;Granada;Andalucía;1178;600;578
3365;Pezuela de las Torres;Madrid;Comunidad de Madrid;842;449;393
6574;Pías;Zamora;Castilla y León;113;65;48
668;Picanya;Valencia/València;Comunidad Valenciana;11513;5709;5804
384;Picassent;Valencia/València;Comunidad Valenciana;20942;10540;10402
3706;Picazo, El;Cuenca;Castilla-La Mancha;666;336;330
3730;Picón;Ciudad Real;Castilla-La Mancha;658;338;320
1408;Piedrabuena;Ciudad Real;Castilla-La Mancha;4395;2239;2156
2355;Piedrahíta;Ávila;Castilla y León;1822;882;940
6981;Piedrahita de Castro;Zamora;Castilla y León;87;47;40
2208;Piedralaves;Ávila;Castilla y León;2061;1024;1037
7788;Piedramillera;Navarra;Navarra;37;24;13
6181;Piedras Albas;Cáceres;Extremadura;147;69;78
6866;Piedratajada;Zaragoza;Aragón;95;51;44
309;Piélagos;Cantabria;Cantabria;25559;12669;12890
520;Piera;Barcelona;Cataluña;15603;7976;7627
7557;Piérnigas;Burgos;Castilla y León;51;33;18
370;Pilar de la Horadada;Alicante/Alacant;Comunidad Valenciana;21905;11236;10669
570;Pilas;Sevilla;Andalucía;13974;7041;6933
1900;Piles;Valencia/València;Comunidad Valenciana;2685;1346;1339
5564;Piles, Les;Tarragona;Cataluña;212;120;92
1014;Piloña;Asturias;Principado de Asturias;6973;3436;3537
2048;Pina de Ebro;Zaragoza;Aragón;2362;1212;1150
6601;Pina de Montalgrao;Castellón/Castelló;Comunidad Valenciana;111;59;52
2318;Pinar de El Hierro, El;Santa Cruz de Tenerife;Canarias;1870;987;883
3316;Pinar, El;Granada;Andalucía;877;460;417
5560;Pinarejo;Cuenca;Castilla-La Mancha;212;109;103
5762;Pinarejos;Segovia;Castilla y León;186;109;77
6848;Pinarnegrillo;Segovia;Castilla y León;96;53;43
7378;Pineda de Gigüela;Cuenca;Castilla-La Mancha;60;37;23
6676;Pineda de la Sierra;Burgos;Castilla y León;106;66;40
290;Pineda de Mar;Barcelona;Cataluña;27272;13588;13684
6562;Pineda Trasmonte;Burgos;Castilla y León;113;65;48
6667;Pinedas;Salamanca;Castilla y León;107;60;47
3108;Pinell de Brai, El;Tarragona;Cataluña;1017;516;501
5644;Pinell de Solsonès;Lleida;Cataluña;200;118;82
6065;Pinet;Valencia/València;Comunidad Valenciana;157;76;81
7576;Pinilla de Jadraque;Guadalajara;Castilla-La Mancha;50;27;23
6859;Pinilla de los Barruecos;Burgos;Castilla y León;95;54;41
7811;Pinilla de los Moros;Burgos;Castilla y León;35;20;15
8113;Pinilla de Molina;Guadalajara;Castilla-La Mancha;10;8;2
5410;Pinilla de Toro;Zamora;Castilla y León;232;125;107
8043;Pinilla del Campo;Soria;Castilla y León;21;12;9
5708;Pinilla del Valle;Madrid;Comunidad de Madrid;191;109;82
5903;Pinilla Trasmonte;Burgos;Castilla y León;171;97;74
8007;Pinillos;Rioja, La;La Rioja;23;13;10
6090;Pino de Tormes, El;Salamanca;Castilla y León;155;83;72
5683;Pino del Oro;Zamora;Castilla y León;195;105;90
5881;Pino del Río;Palencia;Castilla y León;174;106;68
1359;Pino, O;Coruña, A;Galicia;4641;2333;2308
2418;Pinofranqueado;Cáceres;Extremadura;1736;927;809
5047;Pinós;Lleida;Cataluña;287;151;136
2632;Pinos Genil;Granada;Andalucía;1457;758;699
761;Pinos Puente;Granada;Andalucía;9930;4994;4936
908;Pinós, el/Pinoso;Alicante/Alacant;Comunidad Valenciana;7966;4026;3940
1497;Pinseque;Zaragoza;Aragón;3973;2050;1923
7794;Pintanos, Los;Zaragoza;Aragón;37;23;14
139;Pinto;Madrid;Comunidad de Madrid;52526;25964;26562
5519;Piña de Campos;Palencia;Castilla y León;217;109;108
4841;Piña de Esgueva;Valladolid;Castilla y León;324;170;154
2947;Píñar;Granada;Andalucía;1138;623;515
6015;Piñel de Abajo;Valladolid;Castilla y León;161;91;70
6957;Piñel de Arriba;Valladolid;Castilla y León;89;48;41
5449;Piñero, El;Zamora;Castilla y León;227;118;109
2896;Piñor;Ourense;Galicia;1176;595;581
5772;Piñuécar-Gandullas;Madrid;Comunidad de Madrid;185;95;90
2568;Piornal;Cáceres;Extremadura;1519;767;752
1483;Pioz;Guadalajara;Castilla-La Mancha;4052;2117;1935
7488;Piqueras;Guadalajara;Castilla-La Mancha;55;37;18
7613;Piqueras del Castillo;Cuenca;Castilla-La Mancha;48;27;21
4159;Pira;Tarragona;Cataluña;493;261;232
6758;Piracés;Huesca;Aragón;102;54;48
7195;Pitarque;Teruel;Aragón;73;38;35
5782;Pitiegua;Salamanca;Castilla y León;184;102;82
4188;Pitillas;Navarra;Navarra;484;242;242
808;Pizarra;Málaga;Andalucía;9226;4636;4590
7647;Pizarral;Salamanca;Castilla y León;46;30;16
2064;Pla de Santa Maria, El;Tarragona;Cataluña;2327;1215;1112
2804;Pla del Penedès, El;Barcelona;Cataluña;1256;636;620
5067;Plan;Huesca;Aragón;283;143;140
3645;Planes;Alicante/Alacant;Comunidad Valenciana;693;375;318
2451;Planes d'Hostoles, Les;Girona;Cataluña;1683;851;832
5039;Planoles;Girona;Cataluña;288;157;131
4118;Plans de Sió, Els;Lleida;Cataluña;506;272;234
175;Plasencia;Cáceres;Extremadura;39913;19254;20659
4942;Plasencia de Jalón;Zaragoza;Aragón;306;174;132
4160;Plasenzuela;Cáceres;Extremadura;492;251;241
7835;Pleitas;Zaragoza;Aragón;34;14;20
6696;Plenas;Zaragoza;Aragón;106;54;52
1416;Plentzia;Bizkaia;País Vasco;4331;2114;2217
1525;Pliego;Murcia;Región de Murcia;3847;1991;1856
7696;Plou;Teruel;Aragón;43;27;16
3746;Poal, El;Lleida;Cataluña;648;340;308
5621;Pobla de Benifassà, la;Castellón/Castelló;Comunidad Valenciana;202;114;88
5707;Pobla de Cérvoles, La;Lleida;Cataluña;191;107;84
2139;Pobla de Claramunt, La;Barcelona;Cataluña;2193;1104;1089
905;Pobla de Farnals, la;Valencia/València;Comunidad Valenciana;7978;4038;3940
3006;Pobla de Lillet, La;Barcelona;Cataluña;1095;528;567
1509;Pobla de Mafumet, La;Tarragona;Cataluña;3904;1982;1922
4874;Pobla de Massaluca, La;Tarragona;Cataluña;318;181;137
1838;Pobla de Montornès, La;Tarragona;Cataluña;2839;1486;1353
1780;Pobla de Segur, La;Lleida;Cataluña;2984;1469;1515
323;Pobla de Vallbona, la;Valencia/València;Comunidad Valenciana;24433;12312;12121
1959;Pobla del Duc, la;Valencia/València;Comunidad Valenciana;2543;1238;1305
1398;Pobla Llarga, la;Valencia/València;Comunidad Valenciana;4452;2242;2210
2855;Pobla Tornesa, la;Castellón/Castelló;Comunidad Valenciana;1211;618;593
586;Pobla, Sa;Balears, Illes;Islas Baleares;13475;6845;6630
7384;Población de Arroyo;Palencia;Castilla y León;60;32;28
6374;Población de Campos;Palencia;Castilla y León;129;73;56
6642;Población de Cerrato;Palencia;Castilla y León;109;65;44
4605;Pobladura de Pelayo García;León;Castilla y León;373;193;180
7746;Pobladura de Valderaduey;Zamora;Castilla y León;40;22;18
5001;Pobladura del Valle;Zamora;Castilla y León;295;156;139
1923;Poblete;Ciudad Real;Castilla-La Mancha;2626;1347;1279
1887;Poblets, els;Alicante/Alacant;Comunidad Valenciana;2705;1276;1429
6638;Pobo de Dueñas, El;Guadalajara;Castilla-La Mancha;109;56;53
6628;Pobo, El;Teruel;Aragón;110;70;40
4906;Poboleda;Tarragona;Cataluña;313;166;147
2203;Pobra de Trives, A;Ourense;Galicia;2067;1030;1037
2479;Pobra do Brollón, A;Lugo;Galicia;1648;815;833
800;Pobra do Caramiñal, A;Coruña, A;Galicia;9338;4563;4775
483;Poio;Pontevedra;Galicia;17082;8487;8595
2504;Pol;Lugo;Galicia;1609;808;801
1703;Pola de Gordón, La;León;Castilla y León;3224;1628;1596
5405;Polaciones;Cantabria;Cantabria;232;147;85
1524;Polán;Toledo;Castilla-La Mancha;3848;1931;1917
1140;Polanco;Cantabria;Cantabria;5896;2912;2984
7771;Polentinos;Palencia;Castilla y León;38;21;17
5643;Poleñino;Huesca;Aragón;200;107;93
5110;Polícar;Granada;Andalucía;276;147;129
867;Polinyà;Barcelona;Cataluña;8479;4295;4184
1997;Polinyà de Xúquer;Valencia/València;Comunidad Valenciana;2472;1250;1222
504;Pollença;Balears, Illes;Islas Baleares;16283;8088;8195
3878;Pollos;Valladolid;Castilla y León;597;317;280
1307;Polop;Alicante/Alacant;Comunidad Valenciana;4965;2541;2424
2404;Polopos;Granada;Andalucía;1756;976;780
4238;Pomar de Valdivia;Palencia;Castilla y León;470;260;210
8033;Pomer;Zaragoza;Aragón;22;14;8
117;Ponferrada;León;Castilla y León;64674;30671;34003
3907;Ponga;Asturias;Principado de Asturias;586;343;243
4127;Pont d'Armentera, El;Tarragona;Cataluña;505;258;247
6059;Pont de Bar, El;Lleida;Cataluña;157;87;70
4051;Pont de Molins;Girona;Cataluña;529;267;262
2130;Pont de Suert, El;Lleida;Cataluña;2220;1107;1113
1530;Pont de Vilomara i Rocafort, El;Barcelona;Cataluña;3830;1969;1861
1203;Ponte Caldelas;Pontevedra;Galicia;5494;2670;2824
348;Ponteareas;Pontevedra;Galicia;22877;11068;11809
1202;Ponteceso;Coruña, A;Galicia;5502;2756;2746
1750;Pontecesures;Pontevedra;Galicia;3052;1512;1540
927;Pontedeume;Coruña, A;Galicia;7777;3711;4066
4106;Pontedeva;Ourense;Galicia;511;252;259
2102;Pontenova, A;Lugo;Galicia;2264;1082;1182
746;Pontes de García Rodríguez, As;Coruña, A;Galicia;10138;4934;5204
86;Pontevedra;Pontevedra;Galicia;83029;39300;43729
6513;Pontils;Tarragona;Cataluña;117;66;51
4037;Pontons;Barcelona;Cataluña;532;289;243
5168;Pontós;Girona;Cataluña;266;141;125
1934;Ponts;Lleida;Cataluña;2601;1305;1296
1099;Porcuna;Jaén;Andalucía;6235;3144;3091
3415;Porqueira;Ourense;Galicia;815;397;418
1365;Porqueres;Girona;Cataluña;4621;2288;2333
4354;Porrera;Tarragona;Cataluña;439;229;210
1201;Porreres;Balears, Illes;Islas Baleares;5502;2823;2679
415;Porriño, O;Pontevedra;Galicia;19848;9806;10042
3180;Port de la Selva, El;Girona;Cataluña;970;501;469
4680;Portaje;Cáceres;Extremadura;355;183;172
8011;Portalrubio de Guadamejud;Cuenca;Castilla-La Mancha;22;10;12
1798;Portas;Pontevedra;Galicia;2940;1417;1523
3030;Portbou;Girona;Cataluña;1075;528;547
5663;Portell de Morella;Castellón/Castelló;Comunidad Valenciana;197;101;96
3578;Portella, La;Lleida;Cataluña;728;412;316
5388;Portellada, La;Teruel;Aragón;235;118;117
5509;Portezuelo;Cáceres;Extremadura;218;115;103
7389;Portilla;Cuenca;Castilla-La Mancha;59;32;27
2012;Portillo;Valladolid;Castilla y León;2432;1270;1162
8103;Portillo de Soria;Soria;Castilla y León;14;9;5
2133;Portillo de Toledo;Toledo;Castilla-La Mancha;2209;1109;1100
5846;Porto;Zamora;Castilla y León;178;99;79
813;Porto do Son;Coruña, A;Galicia;9171;4562;4609
2617;Portomarín;Lugo;Galicia;1471;761;710
160;Portugalete;Bizkaia;País Vasco;45766;21884;23882
4563;Pórtugos;Granada;Andalucía;382;197;185
1610;Porzuna;Ciudad Real;Castilla-La Mancha;3532;1810;1722
4438;Posada de Valdeón;León;Castilla y León;415;241;174
981;Posadas;Córdoba;Andalucía;7325;3635;3690
2725;Potes;Cantabria;Cantabria;1343;650;693
3067;Potries;Valencia/València;Comunidad Valenciana;1046;528;518
7700;Poveda;Ávila;Castilla y León;42;27;15
6547;Poveda de la Sierra;Guadalajara;Castilla-La Mancha;114;59;55
5573;Poveda de las Cintas;Salamanca;Castilla y León;211;122;89
6432;Póveda de Soria, La;Soria;Castilla y León;123;74;49
4392;Povedilla;Albacete;Castilla-La Mancha;430;241;189
4292;Poyales del Hoyo;Ávila;Castilla y León;453;242;211
7463;Poyatos;Cuenca;Castilla-La Mancha;56;29;27
5045;Poza de la Sal;Burgos;Castilla y León;287;152;135
5882;Poza de la Vega;Palencia;Castilla y León;174;101;73
4018;Pozal de Gallinas;Valladolid;Castilla y León;539;300;239
4196;Pozaldez;Valladolid;Castilla y León;482;255;227
7477;Pozalmuro;Soria;Castilla y León;56;27;29
5436;Pozán de Vero;Huesca;Aragón;228;111;117
7593;Pozanco;Ávila;Castilla y León;49;30;19
1352;Pozo Alcón;Jaén;Andalucía;4673;2398;2275
1853;Pozo Cañada;Albacete;Castilla-La Mancha;2797;1418;1379
6706;Pozo de Almoguera;Guadalajara;Castilla-La Mancha;105;65;40
2757;Pozo de Guadalajara;Guadalajara;Castilla-La Mancha;1303;691;612
7996;Pozo de Urama;Palencia;Castilla y León;24;16;8
4460;Pozo-Lorente;Albacete;Castilla-La Mancha;409;208;201
5017;Pozoamargo;Cuenca;Castilla-La Mancha;292;154;138
5469;Pozoantiguo;Zamora;Castilla y León;224;114;110
477;Pozoblanco;Córdoba;Andalucía;17210;8371;8839
2521;Pozohondo;Albacete;Castilla-La Mancha;1585;826;759
7590;Pozondón;Teruel;Aragón;50;30;20
5827;Pozorrubielos de la Mancha;Cuenca;Castilla-La Mancha;180;92;88
4844;Pozorrubio de Santiago;Cuenca;Castilla-La Mancha;323;155;168
7565;Pozos de Hinojo;Salamanca;Castilla y León;51;28;23
8044;Pozuel de Ariza;Zaragoza;Aragón;21;12;9
7308;Pozuel del Campo;Teruel;Aragón;65;35;30
4197;Pozuelo;Albacete;Castilla-La Mancha;481;255;226
77;Pozuelo de Alarcón;Madrid;Comunidad de Madrid;86422;41354;45068
4996;Pozuelo de Aragón;Zaragoza;Aragón;296;159;137
1601;Pozuelo de Calatrava;Ciudad Real;Castilla-La Mancha;3553;1816;1737
7606;Pozuelo de la Orden;Valladolid;Castilla y León;49;29;20
5986;Pozuelo de Tábara;Zamora;Castilla y León;163;80;83
4228;Pozuelo de Zarzón;Cáceres;Extremadura;475;240;235
4390;Pozuelo del Páramo;León;Castilla y León;431;212;219
2939;Pozuelo del Rey;Madrid;Comunidad de Madrid;1147;603;544
7597;Pozuelo, El;Cuenca;Castilla-La Mancha;49;31;18
4607;Pozuelos de Calatrava, Los;Ciudad Real;Castilla-La Mancha;372;193;179
7485;Prádanos de Bureba;Burgos;Castilla y León;55;34;21
5709;Prádanos de Ojeda;Palencia;Castilla y León;191;102;89
1516;Pradejón;Rioja, La;La Rioja;3871;1985;1886
6129;Pradell de la Teixeta;Tarragona;Cataluña;152;70;82
4072;Prádena;Segovia;Castilla y León;523;277;246
7600;Prádena de Atienza;Guadalajara;Castilla-La Mancha;49;35;14
6510;Prádena del Rincón;Madrid;Comunidad de Madrid;117;65;52
3899;Prades;Tarragona;Cataluña;589;309;280
3968;Pradilla de Ebro;Zaragoza;Aragón;563;298;265
7157;Pradillo;Rioja, La;La Rioja;75;40;35
7531;Prado;Zamora;Castilla y León;53;30;23
6662;Prado de la Guzpeña;León;Castilla y León;107;60;47
1186;Prado del Rey;Cádiz;Andalucía;5605;2807;2798
2915;Pradoluengo;Burgos;Castilla y León;1163;589;574
7185;Prados Redondos;Guadalajara;Castilla-La Mancha;73;48;25
6416;Pradosegar;Ávila;Castilla y León;124;62;62
5799;Prat de Comte;Tarragona;Cataluña;183;98;85
118;Prat de Llobregat, El;Barcelona;Cataluña;64599;31621;32978
3554;Pratdip;Tarragona;Cataluña;738;395;343
1951;Prats de Lluçanès;Barcelona;Cataluña;2569;1280;1289
4038;Prats de Rei, Els;Barcelona;Cataluña;532;283;249
5502;Prats i Sansor;Lleida;Cataluña;219;114;105
892;Pravia;Asturias;Principado de Asturias;8113;3918;4195
4549;Preixana;Lleida;Cataluña;385;199;186
4383;Preixens;Lleida;Cataluña;432;218;214
5547;Préjano;Rioja, La;La Rioja;214;115;99
725;Premià de Dalt;Barcelona;Cataluña;10448;5207;5241
274;Premià de Mar;Barcelona;Cataluña;28119;13704;14415
5991;Presencio;Burgos;Castilla y León;162;100;62
2381;Preses, Les;Girona;Cataluña;1788;890;898
3459;Priaranza del Bierzo;León;Castilla y León;788;401;387
3292;Priego;Cuenca;Castilla-La Mancha;896;455;441
354;Priego de Córdoba;Córdoba;Andalucía;22408;10929;11479
4758;Prioro;León;Castilla y León;340;198;142
3539;Proaza;Asturias;Principado de Asturias;744;431;313
2005;Provencio, El;Cuenca;Castilla-La Mancha;2437;1200;1237
5413;Prullans;Lleida;Cataluña;231;109;122
1932;Pruna;Sevilla;Andalucía;2603;1327;1276
421;Puçol;Valencia/València;Comunidad Valenciana;19495;9590;9905
6503;Puebla de Albortón;Zaragoza;Aragón;118;73;45
2884;Puebla de Alcocer;Badajoz;Extremadura;1184;591;593
1085;Puebla de Alfindén, La;Zaragoza;Aragón;6303;3224;3079
4552;Puebla de Almenara;Cuenca;Castilla-La Mancha;384;199;185
1268;Puebla de Almoradiel, La;Toledo;Castilla-La Mancha;5168;2619;2549
6043;Puebla de Arenoso;Castellón/Castelló;Comunidad Valenciana;158;84;74
4117;Puebla de Arganzón, La;Burgos;Castilla y León;506;274;232
6000;Puebla de Azaba;Salamanca;Castilla y León;162;88;74
7731;Puebla de Beleña;Guadalajara;Castilla-La Mancha;40;24;16
4557;Puebla de Castro, La;Huesca;Aragón;383;196;187
696;Puebla de Cazalla, La;Sevilla;Andalucía;10979;5469;5510
2113;Puebla de Don Fadrique;Granada;Andalucía;2250;1142;1108
2893;Puebla de Don Rodrigo;Ciudad Real;Castilla-La Mancha;1178;650;528
1743;Puebla de Guzmán;Huelva;Andalucía;3073;1581;1492
3291;Puebla de Híjar, La;Teruel;Aragón;897;450;447
1152;Puebla de la Calzada;Badajoz;Extremadura;5845;2917;2928
3549;Puebla de la Reina;Badajoz;Extremadura;741;370;371
7303;Puebla de la Sierra;Madrid;Comunidad de Madrid;65;38;27
3677;Puebla de Lillo;León;Castilla y León;681;394;287
1779;Puebla de los Infantes, La;Sevilla;Andalucía;2991;1486;1505
916;Puebla de Montalbán, La;Toledo;Castilla-La Mancha;7861;3989;3872
2340;Puebla de Obando;Badajoz;Extremadura;1836;931;905
7691;Puebla de Pedraza;Segovia;Castilla y León;43;22;21
7754;Puebla de San Medel;Salamanca;Castilla y León;39;22;17
7349;Puebla de San Miguel;Valencia/València;Comunidad Valenciana;62;39;23
2689;Puebla de Sanabria;Zamora;Castilla y León;1373;670;703
1886;Puebla de Sancho Pérez;Badajoz;Extremadura;2709;1367;1342
6790;Puebla de Valdavia, La;Palencia;Castilla y León;100;55;45
7412;Puebla de Valles;Guadalajara;Castilla-La Mancha;58;32;26
4276;Puebla de Valverde, La;Teruel;Aragón;457;253;204
6163;Puebla de Yeltes;Salamanca;Castilla y León;149;78;71
3665;Puebla del Maestre;Badajoz;Extremadura;685;351;334
3642;Puebla del Príncipe;Ciudad Real;Castilla-La Mancha;694;359;335
4167;Puebla del Prior;Badajoz;Extremadura;490;256;234
655;Puebla del Río, La;Sevilla;Andalucía;11868;5869;5999
5821;Puebla del Salvador;Cuenca;Castilla-La Mancha;181;100;81
2166;Pueblanueva, La;Toledo;Castilla-La Mancha;2140;1077;1063
5786;Pueblica de Valverde;Zamora;Castilla y León;184;101;83
3449;Pueblonuevo de Miramontes;Cáceres;Extremadura;791;402;389
2240;Pueblonuevo del Guadiana;Badajoz;Extremadura;2021;1018;1003
7680;Puendeluna;Zaragoza;Aragón;44;27;17
2591;Puente de Domingo Flórez;León;Castilla y León;1500;790;710
2155;Puente de Génave;Jaén;Andalucía;2159;1080;1079
6949;Puente de Montañana;Huesca;Aragón;89;38;51
2819;Puente del Arzobispo, El;Toledo;Castilla-La Mancha;1246;621;625
5424;Puente del Congosto;Salamanca;Castilla y León;230;129;101
255;Puente Genil;Córdoba;Andalucía;30048;14938;15110
5248;Puente la Reina de Jaca;Huesca;Aragón;255;133;122
1837;Puente la Reina/Gares;Navarra;Navarra;2840;1424;1416
1831;Puente Viesgo;Cantabria;Cantabria;2854;1450;1404
6617;Puentedura;Burgos;Castilla y León;110;76;34
3680;Puentes Viejas;Madrid;Comunidad de Madrid;679;378;301
2098;Puerta de Segura, La;Jaén;Andalucía;2268;1136;1132
7086;Puertas;Salamanca;Castilla y León;79;45;34
6675;Puerto Castilla;Ávila;Castilla y León;106;64;42
4623;Puerto de Béjar;Salamanca;Castilla y León;370;176;194
250;Puerto de la Cruz;Santa Cruz de Tenerife;Canarias;30468;14889;15579
6078;Puerto de San Vicente;Toledo;Castilla-La Mancha;156;83;73
4878;Puerto de Santa Cruz;Cáceres;Extremadura;317;167;150
74;Puerto de Santa María, El;Cádiz;Andalucía;88405;43295;45110
171;Puerto del Rosario;Palmas, Las;Canarias;40753;20640;20113
3260;Puerto Lápice;Ciudad Real;Castilla-La Mancha;924;460;464
528;Puerto Lumbreras;Murcia;Región de Murcia;15394;7778;7616
5076;Puerto Moral;Huelva;Andalucía;282;136;146
169;Puerto Real;Cádiz;Andalucía;41627;20926;20701
7445;Puerto Seguro;Salamanca;Castilla y León;57;27;30
1019;Puerto Serrano;Cádiz;Andalucía;6941;3515;3426
5562;Puértolas;Huesca;Aragón;212;117;95
153;Puertollano;Ciudad Real;Castilla-La Mancha;47035;22753;24282
6645;Puertomingalvo;Teruel;Aragón;109;55;54
4698;Pueyo;Navarra;Navarra;351;192;159
6008;Pueyo de Araguás, El;Huesca;Aragón;161;89;72
4872;Pueyo de Santa Cruz;Huesca;Aragón;318;162;156
857;Puig de Santa Maria, el;Valencia/València;Comunidad Valenciana;8630;4216;4414
1451;Puig-reig;Barcelona;Cataluña;4178;2086;2092
806;Puigcerdà;Girona;Cataluña;9258;4585;4673
4061;Puigdàlber;Barcelona;Cataluña;526;256;270
5112;Puiggròs;Lleida;Cataluña;276;138;138
2937;Puigpelat;Tarragona;Cataluña;1149;590;559
2247;Puigpunyent;Balears, Illes;Islas Baleares;2012;997;1015
5249;Puigverd d'Agramunt;Lleida;Cataluña;255;146;109
2711;Puigverd de Lleida;Lleida;Cataluña;1355;701;654
5577;Pujalt;Barcelona;Cataluña;210;119;91
4966;Pujerra;Málaga;Andalucía;301;158;143
2577;Pulgar;Toledo;Castilla-La Mancha;1508;771;737
1216;Pulianas;Granada;Andalucía;5429;2696;2733
751;Pulpí;Almería;Andalucía;10055;5283;4772
535;Punta Umbría;Huelva;Andalucía;15242;7764;7478
2180;Puntagorda;Santa Cruz de Tenerife;Canarias;2110;1070;1040
1978;Puntallana;Santa Cruz de Tenerife;Canarias;2506;1244;1262
3648;Punxín;Ourense;Galicia;693;342;351
7649;Puras;Valladolid;Castilla y León;46;26;20
2494;Purchena;Almería;Andalucía;1618;851;767
7820;Purujosa;Zaragoza;Aragón;35;25;10
2083;Purullena;Granada;Andalucía;2293;1166;1127
7519;Quar, La;Barcelona;Cataluña;53;29;24
1558;Quart;Girona;Cataluña;3724;1855;1869
3153;Quart de les Valls;Valencia/València;Comunidad Valenciana;988;470;518
318;Quart de Poblet;Valencia/València;Comunidad Valenciana;24760;12053;12707
2486;Quartell;Valencia/València;Comunidad Valenciana;1636;784;852
2132;Quatretonda;Valencia/València;Comunidad Valenciana;2212;1108;1104
6438;Quatretondeta;Alicante/Alacant;Comunidad Valenciana;122;66;56
2210;Quel;Rioja, La;La Rioja;2058;1081;977
5411;Quemada;Burgos;Castilla y León;231;137;94
3248;Quéntar;Granada;Andalucía;933;480;453
3418;Quer;Guadalajara;Castilla-La Mancha;814;423;391
5706;Queralbs;Girona;Cataluña;191;104;87
3155;Quero;Toledo;Castilla-La Mancha;986;510;476
4115;Querol;Tarragona;Cataluña;507;285;222
3701;Quesa;Valencia/València;Comunidad Valenciana;670;348;322
1260;Quesada;Jaén;Andalucía;5209;2645;2564
5084;Quicena;Huesca;Aragón;280;139;141
1635;Quijorna;Madrid;Comunidad de Madrid;3439;1720;1719
1371;Quintana de la Serena;Badajoz;Extremadura;4597;2322;2275
3565;Quintana del Castillo;León;Castilla y León;735;412;323
4655;Quintana del Marco;León;Castilla y León;362;196;166
6135;Quintana del Pidio;Burgos;Castilla y León;151;79;72
5190;Quintana del Puente;Palencia;Castilla y León;263;143;120
4176;Quintana Redonda;Soria;Castilla y León;489;274;215
4697;Quintana y Congosto;León;Castilla y León;351;180;171
7954;Quintanabureba;Burgos;Castilla y León;27;15;12
7639;Quintanaélez;Burgos;Castilla y León;46;24;22
5186;Quintanaortuño;Burgos;Castilla y León;263;149;114
6577;Quintanapalla;Burgos;Castilla y León;112;64;48
691;Quintanar de la Orden;Toledo;Castilla-La Mancha;11030;5471;5559
2473;Quintanar de la Sierra;Burgos;Castilla y León;1658;879;779
943;Quintanar del Rey;Cuenca;Castilla-La Mancha;7586;3901;3685
6200;Quintanas de Gormaz;Soria;Castilla y León;146;90;56
7131;Quintanavides;Burgos;Castilla y León;76;47;29
5984;Quintanilla de Arriba;Valladolid;Castilla y León;163;92;71
6578;Quintanilla de la Mata;Burgos;Castilla y León;112;67;45
3089;Quintanilla de Onésimo;Valladolid;Castilla y León;1028;543;485
5838;Quintanilla de Onsoña;Palencia;Castilla y León;179;105;74
6656;Quintanilla de Trigueros;Valladolid;Castilla y León;108;54;54
6779;Quintanilla de Urz;Zamora;Castilla y León;101;53;48
4602;Quintanilla del Agua y Tordueles;Burgos;Castilla y León;373;198;175
7504;Quintanilla del Coco;Burgos;Castilla y León;54;26;28
7309;Quintanilla del Molar;Valladolid;Castilla y León;65;31;34
6747;Quintanilla del Monte;Zamora;Castilla y León;103;58;45
7876;Quintanilla del Olmo;Zamora;Castilla y León;32;16;16
7053;Quintanilla San García;Burgos;Castilla y León;81;49;32
3421;Quintanilla Vivar;Burgos;Castilla y León;813;430;383
4618;Quintanillas, Las;Burgos;Castilla y León;370;218;152
3825;Quintela de Leirado;Ourense;Galicia;619;274;345
2292;Quinto;Zaragoza;Aragón;1939;977;962
8120;Quiñonería;Soria;Castilla y León;9;5;4
1708;Quiroga;Lugo;Galicia;3207;1523;1684
2924;Quirós;Asturias;Principado de Asturias;1158;671;487
3734;Quiruelas de Vidriales;Zamora;Castilla y León;656;343;313
2566;Quismondo;Toledo;Castilla-La Mancha;1527;780;747
2589;Rábade;Lugo;Galicia;1501;749;752
4080;Rabanales;Zamora;Castilla y León;521;272;249
7871;Rabanera;Rioja, La;La Rioja;32;21;11
6703;Rabanera del Pinar;Burgos;Castilla y León;105;65;40
5854;Rábano;Valladolid;Castilla y León;177;92;85
4629;Rábano de Aliste;Zamora;Castilla y León;369;184;185
7054;Rábanos;Burgos;Castilla y León;81;49;32
4293;Rábanos, Los;Soria;Castilla y León;453;257;196
5494;Rabé de las Calzadas;Burgos;Castilla y León;220;110;110
5841;Rabós;Girona;Cataluña;178;89;89
7670;Rada de Haro;Cuenca;Castilla-La Mancha;44;23;21
1384;Rafal;Alicante/Alacant;Comunidad Valenciana;4498;2240;2258
6291;Ráfales;Teruel;Aragón;138;81;57
835;Rafelbunyol;Valencia/València;Comunidad Valenciana;8941;4390;4551
2722;Rafelcofer;Valencia/València;Comunidad Valenciana;1345;659;686
2060;Rafelguaraf;Valencia/València;Comunidad Valenciana;2335;1156;1179
3738;Ràfol d'Almúnia, el;Alicante/Alacant;Comunidad Valenciana;653;334;319
4263;Ráfol de Salem;Valencia/València;Comunidad Valenciana;462;224;238
5515;Rágama;Salamanca;Castilla y León;218;115;103
4881;Rágol;Almería;Andalucía;316;166;150
2792;Rairiz de Veiga;Ourense;Galicia;1266;648;618
3997;Rajadell;Barcelona;Cataluña;548;275;273
1824;Ramales de la Victoria;Cantabria;Cantabria;2876;1437;1439
956;Rambla, La;Córdoba;Andalucía;7493;3713;3780
2523;Ramirás;Ourense;Galicia;1584;734;850
7698;Ramiro;Valladolid;Castilla y León;43;24;19
5610;Rapariegos;Segovia;Castilla y León;205;105;100
2469;Rascafría;Madrid;Comunidad de Madrid;1664;918;746
6216;Rasillo de Cameros, El;Rioja, La;La Rioja;144;78;66
3253;Rasines;Cantabria;Cantabria;931;478;453
3474;Rasquera;Tarragona;Cataluña;781;384;397
5805;Rasueros;Ávila;Castilla y León;182;101;81
2158;Real;Valencia/València;Comunidad Valenciana;2154;1103;1051
2000;Real de Gandia, el;Valencia/València;Comunidad Valenciana;2461;1204;1257
2586;Real de la Jara, El;Sevilla;Andalucía;1503;742;761
3263;Real de San Vicente, El;Toledo;Castilla-La Mancha;922;494;428
1255;Real Sitio de San Ildefonso;Segovia;Castilla y León;5241;2568;2673
199;Realejos, Los;Santa Cruz de Tenerife;Canarias;36402;17862;18540
5544;Rebollar;Cáceres;Extremadura;214;108;106
7712;Rebollar;Soria;Castilla y León;42;20;22
6753;Rebolledo de la Torre;Burgos;Castilla y León;102;56;46
7062;Rebollo;Segovia;Castilla y León;81;43;38
8109;Rebollosa de Jadraque;Guadalajara;Castilla-La Mancha;11;7;4
1431;Recas;Toledo;Castilla-La Mancha;4262;2362;1900
5337;Recueja, La;Albacete;Castilla-La Mancha;242;133;109
7413;Recuenco, El;Guadalajara;Castilla-La Mancha;58;37;21
7091;Recuerda;Soria;Castilla y León;79;46;33
6232;Redal, El;Rioja, La;La Rioja;143;77;66
6532;Redecilla del Camino;Burgos;Castilla y León;115;73;42
7280;Redecilla del Campo;Burgos;Castilla y León;66;37;29
7158;Redonda, La;Salamanca;Castilla y León;75;43;32
264;Redondela;Pontevedra;Galicia;29218;14208;15010
915;Redován;Alicante/Alacant;Comunidad Valenciana;7869;4069;3800
5215;Redueña;Madrid;Comunidad de Madrid;260;141;119
5152;Regencós;Girona;Cataluña;269;141;128
5085;Regueras de Arriba;León;Castilla y León;280;151;129
2350;Regueras, Las;Asturias;Principado de Asturias;1826;941;885
4757;Regumiel de la Sierra;Burgos;Castilla y León;340;181;159
6492;Reíllo;Cuenca;Castilla-La Mancha;118;62;56
6108;Reina;Badajoz;Extremadura;153;76;77
831;Reinosa;Cantabria;Cantabria;9003;4235;4768
8090;Reinoso;Burgos;Castilla y León;15;10;5
7525;Reinoso de Cerrato;Palencia;Castilla y León;53;35;18
2920;Relleu;Alicante/Alacant;Comunidad Valenciana;1160;599;561
3475;Rellinars;Barcelona;Cataluña;780;403;377
8104;Rello;Soria;Castilla y León;14;9;5
3014;Remolinos;Zaragoza;Aragón;1086;554;532
4971;Remondo;Segovia;Castilla y León;300;159;141
3833;Rena;Badajoz;Extremadura;616;316;300
6064;Renau;Tarragona;Cataluña;157;82;75
1540;Renedo de Esgueva;Valladolid;Castilla y León;3788;1941;1847
5745;Renedo de la Vega;Palencia;Castilla y León;187;103;84
6930;Renera;Guadalajara;Castilla-La Mancha;90;55;35
6725;Renieblas;Soria;Castilla y León;104;63;41
879;Reocín;Cantabria;Cantabria;8384;4142;4242
6081;Requejo;Zamora;Castilla y León;156;74;82
402;Requena;Valencia/València;Comunidad Valenciana;20254;10129;10125
8067;Requena de Campos;Palencia;Castilla y León;18;8;10
6140;Respenda de la Peña;Palencia;Castilla y León;151;89;62
4335;Retamal de Llerena;Badajoz;Extremadura;443;227;216
6726;Retamoso de la Jara;Toledo;Castilla-La Mancha;104;56;48
7276;Retascón;Zaragoza;Aragón;67;40;27
7615;Retiendas;Guadalajara;Castilla-La Mancha;48;33;15
5691;Retortillo;Salamanca;Castilla y León;194;106;88
6164;Retortillo de Soria;Soria;Castilla y León;149;87;62
7326;Retuerta;Burgos;Castilla y León;63;39;24
3231;Retuerta del Bullaque;Ciudad Real;Castilla-La Mancha;941;520;421
60;Reus;Tarragona;Cataluña;104373;50415;53958
5303;Revellinos;Zamora;Castilla y León;249;131;118
6126;Revenga de Campos;Palencia;Castilla y León;152;79;73
7119;Revilla de Collazos;Palencia;Castilla y León;77;43;34
6860;Revilla del Campo;Burgos;Castilla y León;95;59;36
6652;Revilla Vallejera;Burgos;Castilla y León;108;66;42
6733;Revilla y Ahedo, La;Burgos;Castilla y León;103;58;45
4039;Revillarruz;Burgos;Castilla y León;532;273;259
6522;Reyero;León;Castilla y León;116;64;52
8051;Rezmondo;Burgos;Castilla y León;19;6;13
7873;Reznos;Soria;Castilla y León;32;22;10
7945;Riaguas de San Bartolomé;Segovia;Castilla y León;28;19;9
3723;Rialp;Lleida;Cataluña;661;330;331
690;Rianxo;Coruña, A;Galicia;11033;5395;5638
4259;Riaño;León;Castilla y León;463;264;199
2187;Riaza;Segovia;Castilla y León;2098;1118;980
8121;Riba de Escalote, La;Soria;Castilla y León;9;7;2
6707;Riba de Saelices;Guadalajara;Castilla-La Mancha;105;63;42
2965;Riba-roja d'Ebre;Tarragona;Cataluña;1126;593;533
358;Riba-roja de Túria;Valencia/València;Comunidad Valenciana;22264;11271;10993
3914;Riba, La;Tarragona;Cataluña;585;321;264
1297;Ribadavia;Ourense;Galicia;5024;2459;2565
2403;Ribadedeva;Asturias;Principado de Asturias;1756;848;908
762;Ribadeo;Lugo;Galicia;9854;4696;5158
1164;Ribadesella;Asturias;Principado de Asturias;5746;2731;3015
1291;Ribadumia;Pontevedra;Galicia;5052;2459;2593
1548;Ribaforada;Navarra;Navarra;3750;1953;1797
3186;Ribafrecha;Rioja, La;La Rioja;967;501;466
1402;Ribamontán al Mar;Cantabria;Cantabria;4437;2250;2187
2091;Ribamontán al Monte;Cantabria;Cantabria;2276;1181;1095
6231;Ribas de Campos;Palencia;Castilla y León;143;72;71
3227;Ribas de Sil;Lugo;Galicia;947;474;473
3471;Ribatejada;Madrid;Comunidad de Madrid;783;399;384
292;Ribeira;Coruña, A;Galicia;26886;13263;13623
4055;Ribeira de Piquín;Lugo;Galicia;528;274;254
4407;Ribera d'Ondara;Lleida;Cataluña;426;213;213
3243;Ribera d'Urgellet;Lleida;Cataluña;935;488;447
2324;Ribera de Arriba;Asturias;Principado de Asturias;1854;926;928
1662;Ribera del Fresno;Badajoz;Extremadura;3348;1662;1686
7509;Riberos de la Cueza;Palencia;Castilla y León;54;34;20
2408;Ribes de Freser;Girona;Cataluña;1754;882;872
2900;Ribesalbes;Castellón/Castelló;Comunidad Valenciana;1174;610;564
7619;Ribota;Segovia;Castilla y León;48;35;13
1834;Ricla;Zaragoza;Aragón;2847;1517;1330
2794;Ricote;Murcia;Región de Murcia;1264;675;589
3546;Riego de la Vega;León;Castilla y León;742;399;343
3751;Riello;León;Castilla y León;647;364;283
1467;Riells i Viabrea;Girona;Cataluña;4124;2113;2011
3530;Rielves;Toledo;Castilla-La Mancha;752;381;371
2416;Riera de Gaià, La;Tarragona;Cataluña;1744;867;877
6971;Rillo;Teruel;Aragón;88;53;35
7686;Rillo de Gallo;Guadalajara;Castilla-La Mancha;43;25;18
152;Rincón de la Victoria;Málaga;Andalucía;47179;23163;24016
1543;Rincón de Soto;Rioja, La;La Rioja;3783;1927;1856
6591;Rinconada de la Sierra, La;Salamanca;Castilla y León;112;63;49
185;Rinconada, La;Sevilla;Andalucía;38628;19049;19579
5189;Riner;Lleida;Cataluña;263;132;131
6263;Riocabado;Ávila;Castilla y León;140;79;61
7377;Riocavado de la Sierra;Burgos;Castilla y León;60;39;21
6249;Riodeva;Teruel;Aragón;142;69;73
5531;Riofrío;Ávila;Castilla y León;215;126;89
3755;Riofrío de Aliste;Zamora;Castilla y León;646;360;286
7661;Riofrío de Riaza;Segovia;Castilla y León;45;26;19
7489;Riofrío del Llano;Guadalajara;Castilla-La Mancha;55;31;24
1881;Riogordo;Málaga;Andalucía;2724;1429;1295
2655;Rioja;Almería;Andalucía;1417;720;697
2401;Riola;Valencia/València;Comunidad Valenciana;1759;884;875
2839;Riolobos;Cáceres;Extremadura;1231;635;596
3063;Rionansa;Cantabria;Cantabria;1047;581;466
5104;Rionegro del Puente;Zamora;Castilla y León;278;148;130
2734;Riópar;Albacete;Castilla-La Mancha;1332;687;645
2571;Riós;Ourense;Galicia;1516;774;742
2323;Riosa;Asturias;Principado de Asturias;1858;931;927
6433;Rioseco de Soria;Soria;Castilla y León;123;73;50
4600;Rioseco de Tapia;León;Castilla y León;374;211;163
2796;Riotorto;Lugo;Galicia;1262;621;641
2511;Riotuerto;Cantabria;Cantabria;1601;772;829
714;Ripoll;Girona;Cataluña;10686;5273;5413
184;Ripollet;Barcelona;Cataluña;38665;19080;19585
6264;Risco;Badajoz;Extremadura;140;70;70
6888;Riu de Cerdanya;Lleida;Cataluña;93;55;38
2145;Riudarenes;Girona;Cataluña;2182;1125;1057
4215;Riudaura;Girona;Cataluña;478;232;246
2971;Riudecanyes;Tarragona;Cataluña;1124;590;534
2892;Riudecols;Tarragona;Cataluña;1180;611;569
2196;Riudellots de la Selva;Girona;Cataluña;2076;1053;1023
1053;Riudoms;Tarragona;Cataluña;6594;3380;3214
5227;Riumors;Girona;Cataluña;258;126;132
75;Rivas-Vaciamadrid;Madrid;Comunidad de Madrid;88150;43696;44454
7339;Rivilla de Barajas;Ávila;Castilla y León;62;28;34
2143;Roa;Burgos;Castilla y León;2183;1099;1084
3254;Roales;Zamora;Castilla y León;931;493;438
6068;Roales de Campos;Valladolid;Castilla y León;157;88;69
1542;Robla, La;León;Castilla y León;3783;1878;1905
6909;Robladillo;Valladolid;Castilla y León;92;54;38
4161;Robleda;Salamanca;Castilla y León;492;269;223
4485;Robleda-Cervantes;Zamora;Castilla y León;405;223;182
6913;Robledillo de Gata;Cáceres;Extremadura;91;50;41
7071;Robledillo de la Jara;Madrid;Comunidad de Madrid;80;44;36
5175;Robledillo de la Vera;Cáceres;Extremadura;265;134;131
6535;Robledillo de Mohernando;Guadalajara;Castilla-La Mancha;115;60;55
4634;Robledillo de Trujillo;Cáceres;Extremadura;366;183;183
4630;Robledo;Albacete;Castilla-La Mancha;367;200;167
1428;Robledo de Chavela;Madrid;Comunidad de Madrid;4270;2213;2057
7537;Robledo de Corpes;Guadalajara;Castilla-La Mancha;52;30;22
5083;Robledo del Mazo;Toledo;Castilla-La Mancha;281;158;123
3018;Robledo, El;Ciudad Real;Castilla-La Mancha;1081;568;513
4924;Robledollano;Cáceres;Extremadura;310;166;144
5659;Robliza de Cojos;Salamanca;Castilla y León;198;102;96
7415;Robregordo;Madrid;Comunidad de Madrid;58;35;23
4058;Robres;Huesca;Aragón;527;268;259
7925;Robres del Castillo;Rioja, La;La Rioja;29;19;10
2627;Roca de la Sierra, La;Badajoz;Extremadura;1464;718;746
716;Roca del Vallès, La;Barcelona;Cataluña;10650;5319;5331
990;Rocafort;Valencia/València;Comunidad Valenciana;7240;3537;3703
5458;Rocafort de Queralt;Tarragona;Cataluña;225;122;103
918;Rociana del Condado;Huelva;Andalucía;7855;3944;3911
1449;Roda de Andalucía, La;Sevilla;Andalucía;4183;2062;2121
1056;Roda de Berà;Tarragona;Cataluña;6567;3341;3226
5738;Roda de Eresma;Segovia;Castilla y León;188;99;89
1086;Roda de Ter;Barcelona;Cataluña;6301;3118;3183
525;Roda, La;Albacete;Castilla-La Mancha;15476;7818;7658
2006;Rodeiro;Pontevedra;Galicia;2437;1236;1201
7335;Ródenas;Teruel;Aragón;63;35;28
5428;Rodezno;Rioja, La;La Rioja;229;125;104
4170;Rodonyà;Tarragona;Cataluña;490;262;228
6166;Roelos de Sayago;Zamora;Castilla y León;149;73;76
1380;Rois;Coruña, A;Galicia;4512;2144;2368
486;Rojales;Alicante/Alacant;Comunidad Valenciana;16963;8617;8346
7258;Rojas;Burgos;Castilla y León;67;47;20
7743;Rollamienta;Soria;Castilla y León;40;27;13
4616;Rollán;Salamanca;Castilla y León;371;203;168
2009;Romana, la;Alicante/Alacant;Comunidad Valenciana;2434;1263;1171
5220;Romangordo;Cáceres;Extremadura;259;129;130
7798;Romanillos de Atienza;Guadalajara;Castilla-La Mancha;36;24;12
6802;Romanones;Guadalajara;Castilla-La Mancha;99;50;49
6385;Romanos;Zaragoza;Aragón;128;65;63
5875;Romanzado;Navarra;Navarra;175;92;83
3815;Romeral, El;Toledo;Castilla-La Mancha;622;307;315
5571;Roncal/Erronkari;Navarra;Navarra;211;108;103
220;Ronda;Málaga;Andalucía;33877;16427;17450
2700;Ronquillo, El;Sevilla;Andalucía;1364;685;679
4068;Roperuelos del Páramo;León;Castilla y León;524;265;259
66;Roquetas de Mar;Almería;Andalucía;96800;50110;46690
906;Roquetes;Tarragona;Cataluña;7973;4126;3847
2443;Rosal de la Frontera;Huelva;Andalucía;1697;842;855
1100;Rosal, O;Pontevedra;Galicia;6234;3062;3172
2671;Rosalejo;Cáceres;Extremadura;1397;719;678
472;Rosario, El;Santa Cruz de Tenerife;Canarias;17370;8792;8578
419;Roses;Girona;Cataluña;19550;9862;9688
4674;Rosinos de la Requejada;Zamora;Castilla y León;357;195;162
3238;Rossell;Castellón/Castelló;Comunidad Valenciana;937;494;443
1721;Rosselló;Lleida;Cataluña;3145;1602;1543
265;Rota;Cádiz;Andalucía;29109;14505;14604
2948;Rotglà i Corberà;Valencia/València;Comunidad Valenciana;1138;572;566
2762;Rótova;Valencia/València;Comunidad Valenciana;1294;677;617
7859;Roturas;Valladolid;Castilla y León;33;20;13
4638;Rourell, El;Tarragona;Cataluña;366;191;175
5179;Royo, El;Soria;Castilla y León;265;144;121
5615;Royuela;Teruel;Aragón;204;117;87
5820;Royuela de Río Franco;Burgos;Castilla y León;181;109;72
7261;Rozalén del Monte;Cuenca;Castilla-La Mancha;67;31;36
68;Rozas de Madrid, Las;Madrid;Comunidad de Madrid;95814;46285;49529
4047;Rozas de Puerto Real;Madrid;Comunidad de Madrid;530;306;224
5213;Rozas de Valdearroyo, Las;Cantabria;Cantabria;260;147;113
1418;Rúa, A;Ourense;Galicia;4314;2125;2189
7031;Ruanes;Cáceres;Extremadura;83;43;40
5705;Rubena;Burgos;Castilla y León;191;113;78
97;Rubí;Barcelona;Cataluña;77464;38358;39106
5441;Rubí de Bracamonte;Valladolid;Castilla y León;228;129;99
2673;Rubiá;Ourense;Galicia;1393;676;717
7545;Rubiales;Teruel;Aragón;52;30;22
7758;Rubielos de la Cérida;Teruel;Aragón;39;24;15
3818;Rubielos de Mora;Teruel;Aragón;621;326;295
5355;Rubió;Barcelona;Cataluña;239;133;106
1644;Rubio, El;Sevilla;Andalucía;3408;1690;1718
4520;Rubite;Granada;Andalucía;394;213;181
7822;Rublacedo de Abajo;Burgos;Castilla y León;34;18;16
7169;Rucandio;Burgos;Castilla y León;74;36;38
2810;Rueda;Valladolid;Castilla y León;1254;645;609
4929;Rueda de Jalón;Zaragoza;Aragón;310;170;140
7768;Rueda de la Sierra;Guadalajara;Castilla-La Mancha;38;28;10
3109;Ruente;Cantabria;Cantabria;1016;552;464
7114;Ruesca;Zaragoza;Aragón;78;39;39
3367;Ruesga;Cantabria;Cantabria;839;461;378
6050;Rugat;Valencia/València;Comunidad Valenciana;158;83;75
3990;Ruidera;Ciudad Real;Castilla-La Mancha;553;272;281
3550;Ruiloba;Cantabria;Cantabria;740;378;362
5137;Rupià;Girona;Cataluña;272;138;134
5092;Rupit i Pruit;Barcelona;Cataluña;279;139;140
1603;Rus;Jaén;Andalucía;3547;1814;1733
764;Rute;Córdoba;Andalucía;9845;4892;4953
25;Sabadell;Barcelona;Cataluña;213644;103847;109797
2943;Sabero;León;Castilla y León;1140;586;554
3593;Sabiñán;Zaragoza;Aragón;723;388;335
807;Sabiñánigo;Huesca;Aragón;9238;4610;4628
1508;Sabiote;Jaén;Andalucía;3918;1932;1986
7260;Sacañet;Castellón/Castelló;Comunidad Valenciana;67;45;22
6916;Sacecorbo;Guadalajara;Castilla-La Mancha;91;50;41
7717;Saceda-Trasierra;Cuenca;Castilla-La Mancha;41;30;11
2559;Sacedón;Guadalajara;Castilla-La Mancha;1533;790;743
3975;Saceruela;Ciudad Real;Castilla-La Mancha;559;297;262
4642;Sacramenia;Segovia;Castilla y León;365;187;178
515;Sada;Coruña, A;Galicia;15841;7741;8100
6332;Sada;Navarra;Navarra;133;75;58
2739;Sádaba;Zaragoza;Aragón;1324;671;653
4192;Saelices;Cuenca;Castilla-La Mancha;483;252;231
7687;Saelices de la Sal;Guadalajara;Castilla-La Mancha;43;23;20
6571;Saelices de Mayorga;Valladolid;Castilla y León;113;70;43
6154;Saelices el Chico;Salamanca;Castilla y León;150;86;64
6167;Sagàs;Barcelona;Cataluña;148;80;68
4467;Sagra;Alicante/Alacant;Comunidad Valenciana;408;198;210
6864;Sagrada, La;Salamanca;Castilla y León;95;55;40
115;Sagunto/Sagunt;Valencia/València;Comunidad Valenciana;66140;32366;33774
1985;Sahagún;León;Castilla y León;2493;1226;1267
5761;Sahugo, El;Salamanca;Castilla y León;186;103;83
4913;Sahún;Huesca;Aragón;312;160;152
6420;Sajazarra;Rioja, La;La Rioja;124;63;61
44;Salamanca;Salamanca;Castilla y León;144228;65359;78869
1918;Salar;Granada;Andalucía;2631;1319;1312
5924;Salares;Málaga;Andalucía;169;87;82
1311;Salas;Asturias;Principado de Asturias;4959;2449;2510
4884;Salas Altas;Huesca;Aragón;316;161;155
5874;Salas Bajas;Huesca;Aragón;175;86;89
6360;Salas de Bureba;Burgos;Castilla y León;130;73;57
2276;Salas de los Infantes;Burgos;Castilla y León;1965;1016;949
4856;Salàs de Pallars;Lleida;Cataluña;320;174;146
6853;Salce;Zamora;Castilla y León;96;43;53
814;Salceda de Caselas;Pontevedra;Galicia;9164;4566;4598
8105;Salcedillo;Teruel;Aragón;14;9;5
1792;Saldaña;Palencia;Castilla y León;2961;1512;1449
5809;Saldaña de Burgos;Burgos;Castilla y León;182;99;83
6709;Saldeana;Salamanca;Castilla y León;105;62;43
5120;Saldes;Barcelona;Cataluña;274;159;115
6446;Saldías;Navarra;Navarra;122;68;54
7965;Saldón;Teruel;Aragón;27;18;9
6234;Salduero;Soria;Castilla y León;143;78;65
4410;Salem;Valencia/València;Comunidad Valenciana;424;218;206
6101;Sales de Llierca;Girona;Cataluña;154;77;77
6875;Salillas;Huesca;Aragón;94;53;41
4894;Salillas de Jalón;Zaragoza;Aragón;315;155;160
2510;Salinas;Alicante/Alacant;Comunidad Valenciana;1601;826;775
6639;Salinas de Oro/Jaitz;Navarra;Navarra;109;62;47
4865;Salinas de Pisuerga;Palencia;Castilla y León;319;168;151
7249;Salinas del Manzano;Cuenca;Castilla-La Mancha;68;40;28
1309;Salines, Ses;Balears, Illes;Islas Baleares;4960;2525;2435
7595;Salinillas de Bureba;Burgos;Castilla y León;49;40;9
1045;Sallent;Barcelona;Cataluña;6658;3211;3447
2606;Sallent de Gállego;Huesca;Aragón;1478;732;746
6057;Salmerón;Guadalajara;Castilla-La Mancha;157;89;68
6756;Salmeroncillos;Cuenca;Castilla-La Mancha;102;58;44
6390;Salmoral;Salamanca;Castilla y León;127;78;49
6560;Salobral;Ávila;Castilla y León;113;62;51
4203;Salobre;Albacete;Castilla-La Mancha;480;258;222
630;Salobreña;Granada;Andalucía;12381;6161;6220
3978;Salomó;Tarragona;Cataluña;557;295;262
3961;Salorino;Cáceres;Extremadura;565;294;271
285;Salou;Tarragona;Cataluña;27476;14141;13335
239;Salt;Girona;Cataluña;31362;16454;14908
1196;Salteras;Sevilla;Andalucía;5530;2679;2851
4955;Salvacañete;Cuenca;Castilla-La Mancha;303;158;145
7182;Salvadiós;Ávila;Castilla y León;73;34;39
6474;Salvador de Zapardiel;Valladolid;Castilla y León;120;71;49
2406;Salvaleón;Badajoz;Extremadura;1755;877;878
765;Salvaterra de Miño;Pontevedra;Galicia;9819;4905;4914
5653;Salvatierra de Esca;Zaragoza;Aragón;199;93;106
2481;Salvatierra de los Barros;Badajoz;Extremadura;1645;799;846
4911;Salvatierra de Santiago;Cáceres;Extremadura;312;155;157
7087;Salvatierra de Tormes;Salamanca;Castilla y León;79;38;41
3626;Salzadella, la;Castellón/Castelló;Comunidad Valenciana;704;360;344
4882;Samaniego;Araba/Álava;País Vasco;316;158;158
4275;Samboal;Segovia;Castilla y León;457;244;213
5885;Samir de los Caños;Zamora;Castilla y León;174;100;74
2777;Samos;Lugo;Galicia;1278;681;597
3525;Samper de Calanda;Teruel;Aragón;755;387;368
6633;Samper del Salz;Zaragoza;Aragón;110;62;48
1088;San Adrián;Navarra;Navarra;6292;3116;3176
6944;San Adrián de Juarros;Burgos;Castilla y León;89;56;33
6738;San Adrián del Valle;León;Castilla y León;103;57;46
6484;San Agustín;Teruel;Aragón;119;72;47
593;San Agustín del Guadalix;Madrid;Comunidad de Madrid;13379;6565;6814
5802;San Agustín del Pozo;Zamora;Castilla y León;183;95;88
3012;San Amaro;Ourense;Galicia;1089;537;552
7133;San Andrés del Congosto;Guadalajara;Castilla-La Mancha;76;48;28
248;San Andrés del Rabanedo;León;Castilla y León;30615;14574;16041
7923;San Andrés del Rey;Guadalajara;Castilla-La Mancha;29;16;13
1461;San Andrés y Sauces;Santa Cruz de Tenerife;Canarias;4141;2074;2067
821;San Antonio de Benagéber;Valencia/València;Comunidad Valenciana;9089;4477;4612
2984;San Asensio;Rioja, La;La Rioja;1114;589;525
437;San Bartolomé;Palmas, Las;Canarias;18816;9418;9398
7780;San Bartolomé de Béjar;Ávila;Castilla y León;37;19;18
7636;San Bartolomé de Corneja;Ávila;Castilla y León;46;23;23
1553;San Bartolomé de la Torre;Huelva;Andalucía;3736;1864;1872
4323;San Bartolomé de las Abiertas;Toledo;Castilla-La Mancha;447;235;212
4007;San Bartolomé de Pinares;Ávila;Castilla y León;541;294;247
136;San Bartolomé de Tirajana;Palmas, Las;Canarias;53443;27888;25555
2974;San Carlos del Valle;Ciudad Real;Castilla-La Mancha;1120;574;546
4439;San Cebrián de Campos;Palencia;Castilla y León;415;232;183
5364;San Cebrián de Castro;Zamora;Castilla y León;239;117;122
6319;San Cebrián de Mazote;Valladolid;Castilla y León;135;82;53
6074;San Cebrián de Mudá;Palencia;Castilla y León;156;88;68
1221;San Cibrao das Viñas;Ourense;Galicia;5405;2752;2653
1013;San Clemente;Cuenca;Castilla-La Mancha;6988;3511;3477
8020;San Cristóbal de Boedo;Palencia;Castilla y León;22;14;8
6143;San Cristóbal de Cuéllar;Segovia;Castilla y León;151;82;69
2676;San Cristóbal de Entreviñas;Zamora;Castilla y León;1385;724;661
3074;San Cristóbal de la Cuesta;Salamanca;Castilla y León;1039;552;487
41;San Cristóbal de La Laguna;Santa Cruz de Tenerife;Canarias;157503;76211;81292
3656;San Cristóbal de la Polantera;León;Castilla y León;689;358;331
6777;San Cristóbal de la Vega;Segovia;Castilla y León;101;54;47
1751;San Cristóbal de Segovia;Segovia;Castilla y León;3051;1528;1523
2170;San Cristovo de Cea;Ourense;Galicia;2137;1050;1087
3753;San Emiliano;León;Castilla y León;646;361;285
1773;San Esteban de Gormaz;Soria;Castilla y León;3005;1576;1429
4741;San Esteban de la Sierra;Salamanca;Castilla y León;343;194;149
4032;San Esteban de Litera;Huesca;Aragón;535;270;265
7878;San Esteban de los Patos;Ávila;Castilla y León;31;20;11
5244;San Esteban de Nogales;León;Castilla y León;256;132;124
7781;San Esteban de Zapardiel;Ávila;Castilla y León;37;23;14
6384;San Esteban del Molar;Zamora;Castilla y León;128;74;54
3596;San Esteban del Valle;Ávila;Castilla y León;720;372;348
7570;San Felices;Soria;Castilla y León;51;32;19
2049;San Felices de Buelna;Cantabria;Cantabria;2361;1192;1169
4517;San Felices de los Gallegos;Salamanca;Castilla y León;395;206;189
69;San Fernando;Cádiz;Andalucía;94979;46427;48552
179;San Fernando de Henares;Madrid;Comunidad de Madrid;39432;19180;20252
917;San Fulgencio;Alicante/Alacant;Comunidad Valenciana;7855;3964;3891
7147;San García de Ingelmos;Ávila;Castilla y León;75;47;28
2263;San Isidro;Alicante/Alacant;Comunidad Valenciana;1986;1024;962
227;San Javier;Murcia;Región de Murcia;32489;16318;16171
1405;San José del Valle;Cádiz;Andalucía;4418;2257;2161
374;San Juan de Aznalfarache;Sevilla;Andalucía;21416;10309;11107
5241;San Juan de Gredos;Ávila;Castilla y León;256;139;117
7042;San Juan de la Encinilla;Ávila;Castilla y León;82;40;42
4241;San Juan de la Nava;Ávila;Castilla y León;468;251;217
1330;San Juan de la Rambla;Santa Cruz de Tenerife;Canarias;4828;2395;2433
6112;San Juan de Plan;Huesca;Aragón;153;84;69
5661;San Juan del Molinillo;Ávila;Castilla y León;197;114;83
6136;San Juan del Monte;Burgos;Castilla y León;151;83;68
6830;San Juan del Olmo;Ávila;Castilla y León;97;61;36
805;San Juan del Puerto;Huelva;Andalucía;9300;4674;4626
5593;San Justo;Zamora;Castilla y León;208;113;95
2335;San Justo de la Vega;León;Castilla y León;1843;942;901
2218;San Leonardo de Yagüe;Soria;Castilla y León;2044;1038;1006
6572;San Llorente;Valladolid;Castilla y León;113;62;51
5554;San Lorenzo de Calatrava;Ciudad Real;Castilla-La Mancha;213;117;96
450;San Lorenzo de El Escorial;Madrid;Comunidad de Madrid;18369;8803;9566
3069;San Lorenzo de la Parrilla;Cuenca;Castilla-La Mancha;1042;524;518
7879;San Lorenzo de Tormes;Ávila;Castilla y León;31;17;14
5036;San Mamés de Burgos;Burgos;Castilla y León;288;163;125
7541;San Mamés de Campos;Palencia;Castilla y León;52;27;25
7671;San Martín de Boniches;Cuenca;Castilla-La Mancha;44;23;21
428;San Martín de la Vega;Madrid;Comunidad de Madrid;19170;9808;9362
5931;San Martín de la Vega del Alberche;Ávila;Castilla y León;168;97;71
5109;San Martín de la Virgen de Moncayo;Zaragoza;Aragón;277;155;122
3612;San Martín de Montalbán;Toledo;Castilla-La Mancha;712;358;354
4588;San Martín de Oscos;Asturias;Principado de Asturias;377;193;184
3764;San Martín de Pusa;Toledo;Castilla-La Mancha;642;338;304
6222;San Martín de Rubiales;Burgos;Castilla y León;143;83;60
3478;San Martín de Trevejo;Cáceres;Extremadura;778;382;396
4526;San Martín de Unx;Navarra;Navarra;392;207;185
869;San Martín de Valdeiglesias;Madrid;Comunidad de Madrid;8459;4204;4255
7532;San Martín de Valderaduey;Zamora;Castilla y León;53;27;26
7037;San Martín de Valvení;Valladolid;Castilla y León;83;45;38
5477;San Martín del Castañar;Salamanca;Castilla y León;223;121;102
5724;San Martín del Pimpollar;Ávila;Castilla y León;189;112;77
510;San Martín del Rey Aurelio;Asturias;Principado de Asturias;16074;7688;8386
6297;San Martín del Río;Teruel;Aragón;137;72;65
1873;San Martín del Tesorillo;Cádiz;Andalucía;2753;1430;1323
5326;San Martín y Mudrián;Segovia;Castilla y León;245;114;131
1700;San Mateo de Gállego;Zaragoza;Aragón;3234;1668;1566
386;San Miguel de Abona;Santa Cruz de Tenerife;Canarias;20886;10563;10323
6265;San Miguel de Aguayo;Cantabria;Cantabria;140;73;67
6272;San Miguel de Bernuy;Segovia;Castilla y León;140;70;70
7429;San Miguel de Corneja;Ávila;Castilla y León;57;32;25
5025;San Miguel de la Ribera;Zamora;Castilla y León;291;143;148
1124;San Miguel de Salinas;Alicante/Alacant;Comunidad Valenciana;6034;3044;2990
6529;San Miguel de Serrezuela;Ávila;Castilla y León;115;62;53
4787;San Miguel de Valero;Salamanca;Castilla y León;334;173;161
3703;San Miguel del Arroyo;Valladolid;Castilla y León;668;355;313
3446;San Miguel del Cinca;Huesca;Aragón;795;406;389
4706;San Miguel del Pino;Valladolid;Castilla y León;350;180;170
7473;San Miguel del Robledo;Salamanca;Castilla y León;56;33;23
6274;San Miguel del Valle;Zamora;Castilla y León;140;69;71
5423;San Millán de la Cogolla;Rioja, La;La Rioja;230;151;79
7132;San Millán de Lara;Burgos;Castilla y León;76;54;22
5947;San Millán de los Caballeros;León;Castilla y León;167;87;80
7826;San Millán de Yécora;Rioja, La;La Rioja;34;24;10
3603;San Millán/Donemiliaga;Araba/Álava;País Vasco;715;393;322
4788;San Morales;Salamanca;Castilla y León;334;182;152
5401;San Muñoz;Salamanca;Castilla y León;233;116;117
3879;San Nicolás del Puerto;Sevilla;Andalucía;596;309;287
6649;San Pablo de la Moraleja;Valladolid;Castilla y León;109;61;48
2390;San Pablo de los Montes;Toledo;Castilla-La Mancha;1768;887;881
7664;San Pascual;Ávila;Castilla y León;44;26;18
2823;San Pedro;Albacete;Castilla-La Mancha;1242;627;615
5369;San Pedro Bercianos;León;Castilla y León;238;132;106
4312;San Pedro de Ceque;Zamora;Castilla y León;449;233;216
5058;San Pedro de Gaíllos;Segovia;Castilla y León;285;156;129
4726;San Pedro de la Nave-Almendra;Zamora;Castilla y León;347;178;169
4193;San Pedro de Latarce;Valladolid;Castilla y León;483;258;225
3362;San Pedro de Mérida;Badajoz;Extremadura;843;435;408
5023;San Pedro de Rozados;Salamanca;Castilla y León;291;164;127
4387;San Pedro del Arroyo;Ávila;Castilla y León;431;231;200
310;San Pedro del Pinatar;Murcia;Región de Murcia;25476;12828;12648
4113;San Pedro del Romeral;Cantabria;Cantabria;507;283;224
6289;San Pedro del Valle;Salamanca;Castilla y León;138;76;62
3819;San Pedro Manrique;Soria;Castilla y León;620;348;272
7435;San Pedro Palmiches;Cuenca;Castilla-La Mancha;57;32;25
7607;San Pelayo;Valladolid;Castilla y León;49;25;24
6952;San Pelayo de Guareña;Salamanca;Castilla y León;89;51;38
4239;San Rafael del Río;Castellón/Castelló;Comunidad Valenciana;469;233;236
6382;San Román de Cameros;Rioja, La;La Rioja;128;78;50
4917;San Román de Hornija;Valladolid;Castilla y León;312;151;161
7360;San Román de la Cuba;Palencia;Castilla y León;61;36;25
2312;San Román de los Montes;Toledo;Castilla-La Mancha;1881;999;882
242;San Roque;Cádiz;Andalucía;31218;15579;15639
4675;San Roque de Riomiera;Cantabria;Cantabria;356;213;143
1844;San Sadurniño;Coruña, A;Galicia;2822;1396;1426
7973;San Salvador;Valladolid;Castilla y León;26;15;11
819;San Sebastián de la Gomera;Santa Cruz de Tenerife;Canarias;9093;4560;4533
3430;San Sebastián de los Ballesteros;Córdoba;Andalucía;808;406;402
72;San Sebastián de los Reyes;Madrid;Comunidad de Madrid;89276;43550;45726
3809;San Silvestre de Guzmán;Huelva;Andalucía;623;326;297
4452;San Tirso de Abres;Asturias;Principado de Asturias;410;203;207
7363;San Torcuato;Rioja, La;La Rioja;61;31;30
1219;San Vicente de Alcántara;Badajoz;Extremadura;5408;2729;2679
5919;San Vicente de Arévalo;Ávila;Castilla y León;169;99;70
1466;San Vicente de la Barquera;Cantabria;Cantabria;4124;2037;2087
4586;San Vicente de la Cabeza;Zamora;Castilla y León;378;200;178
3148;San Vicente de la Sonsierra;Rioja, La;La Rioja;990;520;470
6016;San Vicente del Palacio;Valladolid;Castilla y León;161;85;76
128;San Vicente del Raspeig/Sant Vicent del Raspeig;Alicante/Alacant;Comunidad Valenciana;58385;28864;29521
7992;San Vicente del Valle;Burgos;Castilla y León;24;19;5
4095;San Vitero;Zamora;Castilla y León;516;287;229
4041;San Xoán de Río;Ourense;Galicia;531;270;261
4573;Sanaüja;Lleida;Cataluña;380;202;178
3983;Sancedo;León;Castilla y León;556;277;279
3598;Sanchidrián;Ávila;Castilla y León;716;365;351
7074;Sanchón de la Ribera;Salamanca;Castilla y León;80;42;38
7755;Sanchón de la Sagrada;Salamanca;Castilla y León;39;23;16
3236;Sanchonuño;Segovia;Castilla y León;940;457;483
7013;Sanchorreja;Ávila;Castilla y León;84;42;42
5520;Sanchotello;Salamanca;Castilla y León;217;115;102
3436;Sancti-Spíritus;Salamanca;Castilla y León;804;434;370
5944;Sancti-Spíritus;Badajoz;Extremadura;167;96;71
2858;Sandiás;Ourense;Galicia;1206;558;648
6431;Sando;Salamanca;Castilla y León;123;75;48
3704;Sanet y Negrals;Alicante/Alacant;Comunidad Valenciana;667;341;326
4897;Sangarcía;Segovia;Castilla y León;314;176;138
5474;Sangarrén;Huesca;Aragón;223;121;102
1308;Sangüesa/Zangoza;Navarra;Navarra;4962;2519;2443
108;Sanlúcar de Barrameda;Cádiz;Andalucía;68684;34209;34475
4464;Sanlúcar de Guadiana;Huelva;Andalucía;409;203;206
576;Sanlúcar la Mayor;Sevilla;Andalucía;13808;6833;6975
6761;Sansol;Navarra;Navarra;102;55;47
196;Sant Adrià de Besòs;Barcelona;Cataluña;37097;18251;18846
7001;Sant Agustí de Lluçanès;Barcelona;Cataluña;85;42;43
280;Sant Andreu de la Barca;Barcelona;Cataluña;27558;13679;13879
698;Sant Andreu de Llavaneres;Barcelona;Cataluña;10968;5424;5544
6085;Sant Andreu Salou;Girona;Cataluña;155;79;76
4750;Sant Aniol de Finestres;Girona;Cataluña;341;177;164
297;Sant Antoni de Portmany;Balears, Illes;Islas Baleares;26306;13788;12518
1111;Sant Antoni de Vilamajor;Barcelona;Cataluña;6135;3031;3104
3343;Sant Bartomeu del Grau;Barcelona;Cataluña;858;460;398
82;Sant Boi de Llobregat;Barcelona;Cataluña;83605;40877;42728
4009;Sant Boi de Lluçanès;Barcelona;Cataluña;541;269;272
550;Sant Carles de la Ràpita;Tarragona;Cataluña;14789;7238;7551
1654;Sant Cebrià de Vallalta;Barcelona;Cataluña;3385;1764;1621
462;Sant Celoni;Barcelona;Cataluña;17904;8939;8965
1463;Sant Climent de Llobregat;Barcelona;Cataluña;4129;2075;2054
3804;Sant Climent Sescebes;Girona;Cataluña;626;364;262
71;Sant Cugat del Vallès;Barcelona;Cataluña;91006;44197;46809
3120;Sant Cugat Sesgarrigues;Barcelona;Cataluña;1007;488;519
6418;Sant Esteve de la Sarga;Lleida;Cataluña;124;72;52
1847;Sant Esteve de Palautordera;Barcelona;Cataluña;2820;1391;1429
939;Sant Esteve Sesrovires;Barcelona;Cataluña;7612;3835;3777
3469;Sant Feliu de Buixalleu;Girona;Cataluña;783;410;373
1095;Sant Feliu de Codines;Barcelona;Cataluña;6259;3168;3091
369;Sant Feliu de Guíxols;Girona;Cataluña;21925;10802;11123
161;Sant Feliu de Llobregat;Barcelona;Cataluña;44860;21767;23093
2693;Sant Feliu de Pallerols;Girona;Cataluña;1371;667;704
3866;Sant Feliu Sasserra;Barcelona;Cataluña;602;312;290
5332;Sant Ferriol;Girona;Cataluña;243;124;119
850;Sant Fost de Campsentelles;Barcelona;Cataluña;8737;4352;4385
854;Sant Fruitós de Bages;Barcelona;Cataluña;8703;4295;4408
1533;Sant Gregori;Girona;Cataluña;3817;1959;1858
3092;Sant Guim de Freixenet;Lleida;Cataluña;1025;538;487
5771;Sant Guim de la Plana;Lleida;Cataluña;185;106;79
1185;Sant Hilari Sacalm;Girona;Cataluña;5627;2843;2784
1623;Sant Hipòlit de Voltregà;Barcelona;Cataluña;3484;1729;1755
2735;Sant Iscle de Vallalta;Barcelona;Cataluña;1332;687;645
1620;Sant Jaume d'Enveja;Tarragona;Cataluña;3503;1765;1738
7900;Sant Jaume de Frontanyà;Barcelona;Cataluña;30;18;12
3335;Sant Jaume de Llierca;Girona;Cataluña;865;416;449
1926;Sant Jaume dels Domenys;Tarragona;Cataluña;2622;1342;1280
2181;Sant Joan;Balears, Illes;Islas Baleares;2108;1039;1069
336;Sant Joan d'Alacant;Alicante/Alacant;Comunidad Valenciana;23915;11538;12377
1079;Sant Joan de Labritja;Balears, Illes;Islas Baleares;6397;3282;3115
1701;Sant Joan de les Abadesses;Girona;Cataluña;3232;1604;1628
4114;Sant Joan de Mollet;Girona;Cataluña;507;248;259
1717;Sant Joan de Moró;Castellón/Castelló;Comunidad Valenciana;3159;1646;1513
699;Sant Joan de Vilatorrada;Barcelona;Cataluña;10936;5490;5446
217;Sant Joan Despí;Barcelona;Cataluña;34123;16585;17538
1771;Sant Joan les Fonts;Girona;Cataluña;3006;1541;1465
4132;Sant Joanet;Valencia/València;Comunidad Valenciana;504;250;254
3507;Sant Jordi Desvalls;Girona;Cataluña;761;380;381
3173;Sant Jordi/San Jorge;Castellón/Castelló;Comunidad Valenciana;972;520;452
287;Sant Josep de sa Talaia;Balears, Illes;Islas Baleares;27413;14114;13299
5434;Sant Julià de Cerdanyola;Barcelona;Cataluña;228;125;103
1616;Sant Julià de Ramis;Girona;Cataluña;3515;1780;1735
1729;Sant Julià de Vilatorta;Barcelona;Cataluña;3114;1539;1575
2769;Sant Julià del Llor i Bonmatí;Girona;Cataluña;1286;651;635
463;Sant Just Desvern;Barcelona;Cataluña;17805;8544;9261
2020;Sant Llorenç d'Hortons;Barcelona;Cataluña;2413;1226;1187
5181;Sant Llorenç de la Muga;Girona;Cataluña;264;135;129
3221;Sant Llorenç de Morunys;Lleida;Cataluña;949;457;492
874;Sant Llorenç des Cardassar;Balears, Illes;Islas Baleares;8431;4167;4264
2040;Sant Llorenç Savall;Barcelona;Cataluña;2373;1197;1176
1029;Sant Lluís;Balears, Illes;Islas Baleares;6798;3458;3340
6576;Sant Martí d'Albars;Barcelona;Cataluña;112;56;56
2909;Sant Martí de Centelles;Barcelona;Cataluña;1167;600;567
3786;Sant Martí de Llémena;Girona;Cataluña;633;330;303
3754;Sant Martí de Riucorb;Lleida;Cataluña;646;334;312
2831;Sant Martí de Tous;Barcelona;Cataluña;1235;637;598
1692;Sant Martí Sarroca;Barcelona;Cataluña;3264;1608;1656
4739;Sant Martí Sesgueioles;Barcelona;Cataluña;343;176;167
5274;Sant Martí Vell;Girona;Cataluña;252;131;121
2278;Sant Mateu;Castellón/Castelló;Comunidad Valenciana;1963;971;992
3862;Sant Mateu de Bages;Barcelona;Cataluña;603;302;301
5412;Sant Miquel de Campmajor;Girona;Cataluña;231;127;104
3497;Sant Miquel de Fluvià;Girona;Cataluña;764;397;367
5849;Sant Mori;Girona;Cataluña;177;90;87
3639;Sant Pau de Segúries;Girona;Cataluña;697;347;350
245;Sant Pere de Ribes;Barcelona;Cataluña;30719;15268;15451
2043;Sant Pere de Riudebitlles;Barcelona;Cataluña;2368;1181;1187
2017;Sant Pere de Torelló;Barcelona;Cataluña;2419;1242;1177
1391;Sant Pere de Vilamajor;Barcelona;Cataluña;4472;2239;2233
2219;Sant Pere Pescador;Girona;Cataluña;2042;1084;958
6119;Sant Pere Sallavinera;Barcelona;Cataluña;152;82;70
1243;Sant Pol de Mar;Barcelona;Cataluña;5299;2604;2695
2109;Sant Quintí de Mediona;Barcelona;Cataluña;2254;1154;1100
2150;Sant Quirze de Besora;Barcelona;Cataluña;2167;1054;1113
410;Sant Quirze del Vallès;Barcelona;Cataluña;20141;9865;10276
3803;Sant Quirze Safaja;Barcelona;Cataluña;627;336;291
4164;Sant Ramon;Lleida;Cataluña;491;254;237
609;Sant Sadurní d'Anoia;Barcelona;Cataluña;12887;6348;6539
7098;Sant Sadurní d'Osormort;Barcelona;Cataluña;78;47;31
1713;Sant Salvador de Guardiola;Barcelona;Cataluña;3179;1630;1549
784;Sant Vicenç de Castellet;Barcelona;Cataluña;9523;4760;4763
1077;Sant Vicenç de Montalt;Barcelona;Cataluña;6407;3199;3208
2209;Sant Vicenç de Torelló;Barcelona;Cataluña;2058;1019;1039
275;Sant Vicenç dels Horts;Barcelona;Cataluña;28117;13959;14158
1489;Santa Amalia;Badajoz;Extremadura;4021;2033;1988
5195;Santa Ana;Cáceres;Extremadura;262;140;122
4689;Santa Ana de Pusa;Toledo;Castilla-La Mancha;353;203;150
4223;Santa Ana la Real;Huelva;Andalucía;476;222;254
1567;Santa Bàrbara;Tarragona;Cataluña;3707;1881;1826
3081;Santa Bárbara de Casa;Huelva;Andalucía;1035;511;524
452;Santa Brígida;Palmas, Las;Canarias;18263;9080;9183
6754;Santa Cecilia;Burgos;Castilla y León;102;63;39
5740;Santa Cecília de Voltregà;Barcelona;Cataluña;187;99;88
6495;Santa Cecilia del Alcor;Palencia;Castilla y León;118;69;49
5351;Santa Cilia;Huesca;Aragón;240;123;117
5941;Santa Clara de Avedillo;Zamora;Castilla y León;168;83;85
6877;Santa Coloma;Rioja, La;La Rioja;94;58;36
888;Santa Coloma de Cervelló;Barcelona;Cataluña;8218;4026;4192
597;Santa Coloma de Farners;Girona;Cataluña;13143;6621;6522
55;Santa Coloma de Gramenet;Barcelona;Cataluña;119215;58895;60320
1905;Santa Coloma de Queralt;Tarragona;Cataluña;2673;1328;1345
4212;Santa Colomba de Curueño;León;Castilla y León;479;255;224
5211;Santa Colomba de las Monjas;Zamora;Castilla y León;261;127;134
4104;Santa Colomba de Somoza;León;Castilla y León;511;275;236
790;Santa Comba;Coruña, A;Galicia;9426;4553;4873
1258;Santa Cristina d'Aro;Girona;Cataluña;5223;2624;2599
3040;Santa Cristina de la Polvorosa;Zamora;Castilla y León;1069;545;524
5164;Santa Cristina de Valmadrigal;León;Castilla y León;267;142;125
4976;Santa Croya de Tera;Zamora;Castilla y León;299;152;147
599;Santa Cruz de Bezana;Cantabria;Cantabria;13095;6443;6652
7618;Santa Cruz de Boedo;Palencia;Castilla y León;48;30;18
6528;Santa Cruz de Grío;Zaragoza;Aragón;116;70;46
519;Santa Cruz de la Palma;Santa Cruz de Tenerife;Canarias;15716;7595;8121
6204;Santa Cruz de la Salceda;Burgos;Castilla y León;145;87;58
5793;Santa Cruz de la Serós;Huesca;Aragón;183;109;74
4819;Santa Cruz de la Sierra;Cáceres;Extremadura;327;167;160
1465;Santa Cruz de la Zarza;Toledo;Castilla-La Mancha;4129;2097;2032
4074;Santa Cruz de los Cáñamos;Ciudad Real;Castilla-La Mancha;522;250;272
5586;Santa Cruz de Marchena;Almería;Andalucía;208;103;105
6365;Santa Cruz de Moncayo;Zaragoza;Aragón;130;70;60
5510;Santa Cruz de Moya;Cuenca;Castilla-La Mancha;218;117;101
1473;Santa Cruz de Mudela;Ciudad Real;Castilla-La Mancha;4107;2034;2073
7927;Santa Cruz de Nogueras;Teruel;Aragón;29;13;16
4843;Santa Cruz de Paniagua;Cáceres;Extremadura;323;180;143
6027;Santa Cruz de Pinares;Ávila;Castilla y León;159;83;76
28;Santa Cruz de Tenerife;Santa Cruz de Tenerife;Canarias;207312;98991;108321
7369;Santa Cruz de Yanguas;Soria;Castilla y León;61;38;23
4054;Santa Cruz del Comercio;Granada;Andalucía;528;273;255
1739;Santa Cruz del Retamar;Toledo;Castilla-La Mancha;3079;1625;1454
4748;Santa Cruz del Valle;Ávila;Castilla y León;341;177;164
6831;Santa Cruz del Valle Urbión;Burgos;Castilla y León;97;63;34
3298;Santa Elena;Jaén;Andalucía;888;464;424
3046;Santa Elena de Jamuz;León;Castilla y León;1066;562;504
6012;Santa Engracia del Jubera;Rioja, La;La Rioja;161;106;55
3524;Santa Eufemia;Córdoba;Andalucía;755;383;372
7164;Santa Eufemia del Arroyo;Valladolid;Castilla y León;75;42;33
5855;Santa Eufemia del Barco;Zamora;Castilla y León;177;102;75
2542;Santa Eugènia;Balears, Illes;Islas Baleares;1561;769;792
2117;Santa Eugènia de Berga;Barcelona;Cataluña;2248;1142;1106
3047;Santa Eulalia;Teruel;Aragón;1061;544;517
6585;Santa Eulalia Bajera;Rioja, La;La Rioja;112;61;51
6867;Santa Eulalia de Gállego;Zaragoza;Aragón;95;52;43
4305;Santa Eulalia de Oscos;Asturias;Principado de Asturias;450;234;216
2721;Santa Eulàlia de Riuprimer;Barcelona;Cataluña;1345;686;659
985;Santa Eulàlia de Ronçana;Barcelona;Cataluña;7288;3639;3649
190;Santa Eulària des Riu;Balears, Illes;Islas Baleares;38015;19254;18761
538;Santa Fe;Granada;Andalucía;15157;7427;7730
4296;Santa Fe de Mondújar;Almería;Andalucía;452;234;218
4598;Santa Fe del Penedès;Barcelona;Cataluña;374;185;189
6168;Santa Gadea del Cid;Burgos;Castilla y León;148;76;72
6240;Santa Inés;Burgos;Castilla y León;142;80;62
4621;Santa Llogaia d'Àlguema;Girona;Cataluña;370;189;181
103;Santa Lucía de Tirajana;Palmas, Las;Canarias;73328;36623;36705
3491;Santa Magdalena de Pulpis;Castellón/Castelló;Comunidad Valenciana;768;405;363
622;Santa Margalida;Balears, Illes;Islas Baleares;12485;6391;6094
755;Santa Margarida de Montbui;Barcelona;Cataluña;9980;4993;4987
941;Santa Margarida i els Monjos;Barcelona;Cataluña;7611;3856;3755
3091;Santa Maria d'Oló;Barcelona;Cataluña;1025;521;504
6149;Santa Maria de Besora;Barcelona;Cataluña;150;78;72
815;Santa María de Cayón;Cantabria;Cantabria;9159;4575;4584
5583;Santa María de Dulcis;Huesca;Aragón;209;113;96
574;Santa María de Guía de Gran Canaria;Palmas, Las;Canarias;13850;6907;6943
5173;Santa María de Huerta;Soria;Castilla y León;266;147;119
2808;Santa María de la Alameda;Madrid;Comunidad de Madrid;1254;665;589
4229;Santa María de la Isla;León;Castilla y León;475;247;228
4921;Santa María de la Vega;Zamora;Castilla y León;311;162;149
6835;Santa María de las Hoyas;Soria;Castilla y León;97;57;40
7279;Santa María de los Caballeros;Ávila;Castilla y León;66;39;27
3686;Santa María de los Llanos;Cuenca;Castilla-La Mancha;676;352;324
3293;Santa Maria de Martorelles;Barcelona;Cataluña;893;449;444
5777;Santa Maria de Merlès;Barcelona;Cataluña;184;89;95
6394;Santa Maria de Miralles;Barcelona;Cataluña;126;68;58
4873;Santa María de Ordás;León;Castilla y León;318;166;152
791;Santa Maria de Palautordera;Barcelona;Cataluña;9423;4760;4663
6626;Santa María de Sando;Salamanca;Castilla y León;110;58;52
7480;Santa María de Valverde;Zamora;Castilla y León;56;28;28
6701;Santa María del Arroyo;Ávila;Castilla y León;105;55;50
4524;Santa María del Berrocal;Ávila;Castilla y León;392;208;184
971;Santa María del Camí;Balears, Illes;Islas Baleares;7375;3664;3711
4057;Santa María del Campo;Burgos;Castilla y León;527;286;241
3951;Santa María del Campo Rus;Cuenca;Castilla-La Mancha;571;293;278
4877;Santa María del Cubillo;Ávila;Castilla y León;317;183;134
7327;Santa María del Invierno;Burgos;Castilla y León;63;46;17
6714;Santa María del Mercadillo;Burgos;Castilla y León;104;69;35
5448;Santa María del Monte de Cea;León;Castilla y León;227;125;102
1734;Santa María del Páramo;León;Castilla y León;3089;1519;1570
4330;Santa María del Tiétar;Ávila;Castilla y León;445;232;213
7262;Santa María del Val;Cuenca;Castilla-La Mancha;67;39;28
3174;Santa María la Real de Nieva;Segovia;Castilla y León;972;529;443
6929;Santa María Rivarredonda;Burgos;Castilla y León;90;57;33
2297;Santa Marina del Rey;León;Castilla y León;1916;956;960
1468;Santa Marta;Badajoz;Extremadura;4122;2078;2044
5073;Santa Marta de Magasca;Cáceres;Extremadura;282;140;142
548;Santa Marta de Tormes;Salamanca;Castilla y León;14805;7271;7534
7816;Santa Marta del Cerro;Segovia;Castilla y León;35;19;16
1696;Santa Olalla;Toledo;Castilla-La Mancha;3251;1654;1597
7812;Santa Olalla de Bureba;Burgos;Castilla y León;35;26;9
2253;Santa Olalla del Cala;Huelva;Andalucía;2001;1035;966
1674;Santa Oliva;Tarragona;Cataluña;3320;1685;1635
2539;Santa Pau;Girona;Cataluña;1565;792;773
304;Santa Perpètua de Mogoda;Barcelona;Cataluña;25799;12958;12841
228;Santa Pola;Alicante/Alacant;Comunidad Valenciana;32306;16225;16081
1633;Santa Susanna;Barcelona;Cataluña;3446;1721;1725
553;Santa Úrsula;Santa Cruz de Tenerife;Canarias;14679;7319;7360
3320;Santacara;Navarra;Navarra;874;456;418
1363;Santaella;Córdoba;Andalucía;4629;2327;2302
7048;Santaliestra y San Quílez;Huesca;Aragón;82;41;41
38;Santander;Cantabria;Cantabria;172539;79555;92984
634;Santanyí;Balears, Illes;Islas Baleares;12237;6163;6074
3543;Santas Martas;León;Castilla y León;743;400;343
7336;Santed;Zaragoza;Aragón;63;39;24
6500;Santervás de Campos;Valladolid;Castilla y León;118;61;57
4341;Santervás de la Vega;Palencia;Castilla y León;442;253;189
4070;Santiago de Alcántara;Cáceres;Extremadura;523;255;268
3636;Santiago de Calatrava;Jaén;Andalucía;699;371;328
65;Santiago de Compostela;Coruña, A;Galicia;97260;45179;52081
4926;Santiago de la Puebla;Salamanca;Castilla y León;310;161;149
5272;Santiago del Campo;Cáceres;Extremadura;252;126;126
5888;Santiago del Collado;Ávila;Castilla y León;173;110;63
686;Santiago del Teide;Santa Cruz de Tenerife;Canarias;11111;5538;5573
6488;Santiago del Tormes;Ávila;Castilla y León;118;68;50
4765;Santiago Millas;León;Castilla y León;338;186;152
1794;Santiago-Pontones;Jaén;Andalucía;2956;1521;1435
4266;Santibáñez de Béjar;Salamanca;Castilla y León;461;233;228
7542;Santibáñez de Ecla;Palencia;Castilla y León;52;29;23
7030;Santibáñez de Esgueva;Burgos;Castilla y León;83;46;37
3082;Santibáñez de la Peña;Palencia;Castilla y León;1035;510;525
5831;Santibáñez de la Sierra;Salamanca;Castilla y León;180;102;78
4561;Santibáñez de Tera;Zamora;Castilla y León;383;191;192
5975;Santibáñez de Valcorba;Valladolid;Castilla y León;164;92;72
3204;Santibáñez de Vidriales;Zamora;Castilla y León;958;485;473
7611;Santibáñez del Val;Burgos;Castilla y León;48;31;17
4619;Santibáñez el Alto;Cáceres;Extremadura;370;203;167
3518;Santibáñez el Bajo;Cáceres;Extremadura;756;385;371
1442;Santillana del Mar;Cantabria;Cantabria;4207;2056;2151
864;Santiponce;Sevilla;Andalucía;8554;4248;4306
2522;Santiso;Coruña, A;Galicia;1584;816;768
1393;Santisteban del Puerto;Jaén;Andalucía;4472;2304;2168
5247;Santiurde de Reinosa;Cantabria;Cantabria;255;147;108
2489;Santiurde de Toranzo;Cantabria;Cantabria;1629;847;782
8100;Santiuste;Guadalajara;Castilla-La Mancha;14;8;6
6905;Santiuste de Pedraza;Segovia;Castilla y León;92;59;33
4003;Santiuste de San Juan Bautista;Segovia;Castilla y León;545;302;243
5299;Santiz;Salamanca;Castilla y León;249;134;115
5034;Santo Adriano;Asturias;Principado de Asturias;288;144;144
1097;Santo Domingo de la Calzada;Rioja, La;La Rioja;6238;3095;3143
6986;Santo Domingo de las Posadas;Ávila;Castilla y León;86;44;42
7423;Santo Domingo de Pirón;Segovia;Castilla y León;58;33;25
5093;Santo Domingo de Silos;Burgos;Castilla y León;279;173;106
3075;Santo Domingo-Caudilla;Toledo;Castilla-La Mancha;1038;551;487
2167;Santo Tomé;Jaén;Andalucía;2139;1087;1052
7296;Santo Tomé de Zabarcos;Ávila;Castilla y León;65;35;30
5279;Santo Tomé del Puerto;Segovia;Castilla y León;252;140;112
505;Santomera;Murcia;Región de Murcia;16206;8124;8082
693;Santoña;Cantabria;Cantabria;11024;5374;5650
3301;Santorcaz;Madrid;Comunidad de Madrid;886;467;419
1943;Santos de la Humosa, Los;Madrid;Comunidad de Madrid;2590;1320;1270
895;Santos de Maimona, Los;Badajoz;Extremadura;8091;4087;4004
3848;Santos, Los;Salamanca;Castilla y León;610;313;297
5347;Santovenia;Zamora;Castilla y León;241;118;123
2176;Santovenia de la Valdoncina;León;Castilla y León;2126;1083;1043
1390;Santovenia de Pisuerga;Valladolid;Castilla y León;4480;2310;2170
5730;Santoyo;Palencia;Castilla y León;189;101;88
947;Santpedor;Barcelona;Cataluña;7554;3755;3799
5055;Santurde de Rioja;Rioja, La;La Rioja;286;151;135
6685;Santurdejo;Rioja, La;La Rioja;106;68;38
159;Santurtzi;Bizkaia;País Vasco;45853;22023;23830
473;Sanxenxo;Pontevedra;Galicia;17347;8565;8782
4163;Sanzoles;Zamora;Castilla y León;492;249;243
3929;Sardón de Duero;Valladolid;Castilla y León;580;313;267
6964;Sardón de los Frailes;Salamanca;Castilla y León;88;49;39
6506;Sargentes de la Lora;Burgos;Castilla y León;117;66;51
2811;Sariego;Asturias;Principado de Asturias;1252;604;648
1292;Sariegos;León;Castilla y León;5050;2528;2522
1455;Sariñena;Huesca;Aragón;4160;2160;2000
4130;Saro;Cantabria;Cantabria;504;262;242
5271;Sarracín;Burgos;Castilla y León;252;135;117
2549;Sarral;Tarragona;Cataluña;1548;789;759
2918;Sarreaus;Ourense;Galicia;1162;574;588
594;Sarria;Lugo;Galicia;13330;6492;6838
1267;Sarrià de Ter;Girona;Cataluña;5170;2530;2640
7417;Sarriés/Sartze;Navarra;Navarra;58;38;20
2962;Sarrión;Teruel;Aragón;1128;590;538
6457;Sarroca de Bellera;Lleida;Cataluña;121;68;53
4652;Sarroca de Lleida;Lleida;Cataluña;363;200;163
2748;Sartaguda;Navarra;Navarra;1315;677;638
6852;Sartajada;Toledo;Castilla-La Mancha;96;58;38
3158;Sasamón;Burgos;Castilla y León;983;561;422
2933;Sástago;Zaragoza;Aragón;1154;578;576
7538;Saúca;Guadalajara;Castilla-La Mancha;52;31;21
3356;Saucedilla;Cáceres;Extremadura;851;443;408
1426;Saucejo, El;Sevilla;Andalucía;4284;2121;2163
5113;Saucelle;Salamanca;Castilla y León;276;140;136
6156;Sauquillo de Cabezas;Segovia;Castilla y León;150;83;67
3370;Saus, Camallera i Llampaies;Girona;Cataluña;837;424;413
837;Sauzal, El;Santa Cruz de Tenerife;Canarias;8934;4409;4525
7424;Savallà del Comtat;Tarragona;Cataluña;58;31;27
1555;Saviñao, O;Lugo;Galicia;3735;1892;1843
763;Sax;Alicante/Alacant;Comunidad Valenciana;9845;4968;4877
2455;Sayalonga;Málaga;Andalucía;1681;863;818
7102;Sayatón;Guadalajara;Castilla-La Mancha;78;46;32
5132;Sebúlcor;Segovia;Castilla y León;273;143;130
3026;Seca, La;Valladolid;Castilla y León;1077;548;529
6268;Secastilla;Huesca;Aragón;140;62;78
2448;Secuita, La;Tarragona;Cataluña;1687;851;836
737;Sedaví;Valencia/València;Comunidad Valenciana;10333;5040;5293
3855;Sedella;Málaga;Andalucía;606;341;265
6767;Sediles;Zaragoza;Aragón;102;59;43
5983;Segart;Valencia/València;Comunidad Valenciana;163;84;79
833;Segorbe;Castellón/Castelló;Comunidad Valenciana;8978;4427;4551
140;Segovia;Segovia;Castilla y León;51674;24181;27493
2623;Segura;Gipuzkoa;País Vasco;1467;742;725
2379;Segura de la Sierra;Jaén;Andalucía;1790;874;916
2307;Segura de León;Badajoz;Extremadura;1889;942;947
7776;Segura de los Baños;Teruel;Aragón;38;24;14
5789;Segura de Toro;Cáceres;Extremadura;183;90;93
2738;Segurilla;Toledo;Castilla-La Mancha;1324;666;658
6173;Seira;Huesca;Aragón;148;83;65
7643;Selas;Guadalajara;Castilla-La Mancha;46;23;23
2305;Selaya;Cantabria;Cantabria;1891;951;940
3927;Sella;Alicante/Alacant;Comunidad Valenciana;580;306;274
4536;Sellent;Valencia/València;Comunidad Valenciana;389;191;198
1491;Selva;Balears, Illes;Islas Baleares;4014;1991;2023
5673;Selva de Mar, La;Girona;Cataluña;196;108;88
1180;Selva del Camp, La;Tarragona;Cataluña;5652;2836;2816
7799;Semillas;Guadalajara;Castilla-La Mancha;36;21;15
7832;Sempere;Valencia/València;Comunidad Valenciana;34;19;15
4154;Sena;Huesca;Aragón;495;265;230
4558;Sena de Luna;León;Castilla y León;383;189;194
7620;Senan;Tarragona;Cataluña;48;33;15
1685;Sencelles;Balears, Illes;Islas Baleares;3290;1654;1636
4997;Senés;Almería;Andalucía;295;156;139
7720;Senés de Alcubierre;Huesca;Aragón;41;22;19
1176;Sénia, La;Tarragona;Cataluña;5681;2844;2837
3915;Senija;Alicante/Alacant;Comunidad Valenciana;584;302;282
7697;Seno;Teruel;Aragón;43;19;24
6294;Senterada;Lleida;Cataluña;137;80;57
4478;Sentiu de Sió, La;Lleida;Cataluña;406;216;190
822;Sentmenat;Barcelona;Cataluña;9078;4611;4467
2951;Senyera;Valencia/València;Comunidad Valenciana;1136;563;573
5863;Sepulcro-Hilario;Salamanca;Castilla y León;176;100;76
3128;Sepúlveda;Segovia;Castilla y León;1003;515;488
7817;Sequera de Fresno;Segovia;Castilla y León;35;23;12
7881;Sequera de Haza, La;Burgos;Castilla y León;31;22;9
5379;Sequeros;Salamanca;Castilla y León;237;117;120
2950;Serinyà;Girona;Cataluña;1136;576;560
7060;Serna del Monte, La;Madrid;Comunidad de Madrid;81;42;39
6844;Serna, La;Palencia;Castilla y León;96;62;34
2220;Serón;Almería;Andalucía;2041;1044;997
6422;Serón de Nágima;Soria;Castilla y León;124;73;51
2296;Seròs;Lleida;Cataluña;1922;1029;893
1725;Serra;Valencia/València;Comunidad Valenciana;3124;1618;1506
5488;Serra de Daró;Girona;Cataluña;221;122;99
2952;Serrada;Valladolid;Castilla y León;1136;593;543
6504;Serrada, La;Ávila;Castilla y León;117;60;57
2553;Serradilla;Cáceres;Extremadura;1537;777;760
5208;Serradilla del Arroyo;Salamanca;Castilla y León;261;144;117
6091;Serradilla del Llano;Salamanca;Castilla y León;155;79;76
5314;Serranillos;Ávila;Castilla y León;247;139;108
1453;Serranillos del Valle;Madrid;Comunidad de Madrid;4165;2060;2105
6770;Serratella, la;Castellón/Castelló;Comunidad Valenciana;101;52;49
4222;Serrato;Málaga;Andalucía;477;240;237
4463;Serrejón;Cáceres;Extremadura;409;213;196
6009;Sesa;Huesca;Aragón;161;90;71
303;Seseña;Toledo;Castilla-La Mancha;25835;13283;12552
2913;Sesma;Navarra;Navarra;1164;596;568
289;Sestao;Bizkaia;País Vasco;27296;13195;14101
4695;Sestrica;Zaragoza;Aragón;352;202;150
6444;Sesué;Huesca;Aragón;122;63;59
5850;Setcases;Girona;Cataluña;177;98;79
1867;Setenil de las Bodegas;Cádiz;Andalucía;2769;1430;1339
7070;Setiles;Guadalajara;Castilla-La Mancha;80;47;33
643;Seu d'Urgell, La;Lleida;Cataluña;12089;5842;6247
1615;Seva;Barcelona;Cataluña;3519;1784;1735
4;Sevilla;Sevilla;Andalucía;688592;326634;361958
803;Sevilla la Nueva;Madrid;Comunidad de Madrid;9318;4546;4772
3674;Sevilleja de la Jara;Toledo;Castilla-La Mancha;682;371;311
3567;Sidamon;Lleida;Cataluña;734;383;351
7577;Sienes;Guadalajara;Castilla-La Mancha;50;29;21
141;Siero;Asturias;Principado de Asturias;51667;25255;26412
7740;Sierpe, La;Salamanca;Castilla y León;40;20;20
2256;Sierra de Fuentes;Cáceres;Extremadura;1998;1017;981
5160;Sierra de Luna;Zaragoza;Aragón;268;139;129
1663;Sierra de Yeguas;Málaga;Andalucía;3346;1690;1656
3166;Sierra Engarcerán;Castellón/Castelló;Comunidad Valenciana;976;513;463
4564;Sierro;Almería;Andalucía;381;204;177
3679;Siétamo;Huesca;Aragón;679;369;310
2932;Siete Aguas;Valencia/València;Comunidad Valenciana;1154;611;543
4402;Siete Iglesias de Trabancos;Valladolid;Castilla y León;428;229;199
5748;Sieteiglesias de Tormes;Salamanca;Castilla y León;187;89;98
7637;Sigeres;Ávila;Castilla y León;46;23;23
1420;Sigüenza;Guadalajara;Castilla-La Mancha;4309;2157;2152
7039;Sigüés;Zaragoza;Aragón;83;44;39
2119;Siles;Jaén;Andalucía;2241;1115;1126
439;Silla;Valencia/València;Comunidad Valenciana;18771;9325;9446
855;Silleda;Pontevedra;Galicia;8687;4212;4475
1349;Silos, Los;Santa Cruz de Tenerife;Canarias;4693;2348;2345
1115;Sils;Girona;Cataluña;6093;3108;2985
1247;Simancas;Valladolid;Castilla y León;5276;2678;2598
1668;Simat de la Valldigna;Valencia/València;Comunidad Valenciana;3329;1658;1671
2966;Sinarcas;Valencia/València;Comunidad Valenciana;1125;581;544
1519;Sineu;Balears, Illes;Islas Baleares;3862;1913;1949
7161;Singra;Teruel;Aragón;75;44;31
6238;Sinlabajos;Ávila;Castilla y León;142;73;69
2301;Siruela;Badajoz;Extremadura;1903;962;941
7929;Sisamón;Zaragoza;Aragón;29;18;11
2484;Sisante;Cuenca;Castilla-La Mancha;1642;826;816
261;Sitges;Barcelona;Cataluña;29307;14708;14599
5933;Siurana;Girona;Cataluña;168;84;84
2891;Soba;Cantabria;Cantabria;1180;655;525
2073;Sober;Lugo;Galicia;2312;1137;1175
3004;Sobradiel;Zaragoza;Aragón;1096;523;573
5504;Sobradillo;Salamanca;Castilla y León;219;112;107
2402;Sobrado;Coruña, A;Galicia;1758;909;849
4914;Sobrado;León;Castilla y León;312;159;153
7081;Sobremunt;Barcelona;Cataluña;79;36;43
3424;Sobrescobio;Asturias;Principado de Asturias;811;433;378
2382;Socovos;Albacete;Castilla-La Mancha;1787;920;867
639;Socuéllamos;Ciudad Real;Castilla-La Mancha;12139;6103;6036
4905;Sojuela;Rioja, La;La Rioja;313;179;134
6616;Solana de Ávila;Ávila;Castilla y León;110;64;46
1925;Solana de los Barros;Badajoz;Extremadura;2623;1308;1315
6028;Solana de Rioalmar;Ávila;Castilla y León;159;93;66
4839;Solana del Pino;Ciudad Real;Castilla-La Mancha;324;171;153
524;Solana, La;Ciudad Real;Castilla-La Mancha;15479;7832;7647
6917;Solanillos del Extremo;Guadalajara;Castilla-La Mancha;91;53;38
7170;Solarana;Burgos;Castilla y León;74;42;32
7938;Solera de Gabaldón;Cuenca;Castilla-La Mancha;28;15;13
4798;Soleràs, El;Lleida;Cataluña;332;173;159
7874;Soliedra;Soria;Castilla y León;32;18;14
3788;Solivella;Tarragona;Cataluña;633;333;300
1323;Sollana;Valencia/València;Comunidad Valenciana;4861;2376;2485
579;Sóller;Balears, Illes;Islas Baleares;13705;6850;6855
3064;Solórzano;Cantabria;Cantabria;1047;563;484
3393;Solosancho;Ávila;Castilla y León;827;437;390
818;Solsona;Lleida;Cataluña;9094;4488;4606
2934;Somiedo;Asturias;Principado de Asturias;1153;676;477
7904;Somolinos;Guadalajara;Castilla-La Mancha;30;15;15
4325;Somontín;Almería;Andalucía;446;228;218
6992;Somosierra;Madrid;Comunidad de Madrid;86;50;36
3000;Somozas, As;Coruña, A;Galicia;1098;550;548
664;Son Servera;Balears, Illes;Islas Baleares;11568;5776;5792
1383;Sondika;Bizkaia;País Vasco;4502;2173;2329
2641;Soneja;Castellón/Castelló;Comunidad Valenciana;1447;712;735
688;Sonseca;Toledo;Castilla-La Mancha;11067;5585;5482
6919;Sopeira;Huesca;Aragón;91;51;40
572;Sopela;Bizkaia;País Vasco;13878;6844;7034
5157;Soportújar;Granada;Andalucía;268;147;121
1971;Sopuerta;Bizkaia;País Vasco;2527;1247;1280
5581;Sora;Barcelona;Cataluña;209;117;92
1514;Soraluze-Placencia de las Armas;Gipuzkoa;País Vasco;3883;1945;1938
2036;Sorbas;Almería;Andalucía;2388;1254;1134
7932;Sordillos;Burgos;Castilla y León;28;17;11
181;Soria;Soria;Castilla y León;39398;18579;20819
4455;Soriguera;Lleida;Cataluña;410;220;190
5209;Sorihuela;Salamanca;Castilla y León;261;138;123
2999;Sorihuela del Guadalimar;Jaén;Andalucía;1100;572;528
7443;Sorlada;Navarra;Navarra;57;35;22
2159;Sort;Lleida;Cataluña;2149;1077;1072
4021;Sorvilán;Granada;Andalucía;538;297;241
5481;Sorzano;Rioja, La;La Rioja;222;125;97
3895;Sos del Rey Católico;Zaragoza;Aragón;590;312;278
2396;Soses;Lleida;Cataluña;1763;923;840
4626;Sot de Chera;Valencia/València;Comunidad Valenciana;369;202;167
4436;Sot de Ferrer;Castellón/Castelló;Comunidad Valenciana;415;212;203
5242;Sotalbo;Ávila;Castilla y León;256;141;115
5006;Sotés;Rioja, La;La Rioja;294;165;129
7961;Sotillo;Segovia;Castilla y León;27;15;12
1373;Sotillo de la Adrada;Ávila;Castilla y León;4590;2269;2321
4168;Sotillo de la Ribera;Burgos;Castilla y León;490;250;240
5801;Sotillo de las Palomas;Toledo;Castilla-La Mancha;183;92;91
5723;Sotillo del Rincón;Soria;Castilla y León;190;100;90
7707;Sotillo, El;Guadalajara;Castilla-La Mancha;42;22;20
5773;Soto de Cerrato;Palencia;Castilla y León;185;106;79
2562;Soto de la Vega;León;Castilla y León;1529;805;724
1517;Soto del Barco;Asturias;Principado de Asturias;3866;1916;1950
844;Soto del Real;Madrid;Comunidad de Madrid;8799;4302;4497
6951;Soto en Cameros;Rioja, La;La Rioja;89;52;37
3470;Soto y Amío;León;Castilla y León;783;408;375
6246;Sotobañado y Priorato;Palencia;Castilla y León;142;83;59
7847;Sotodosos;Guadalajara;Castilla-La Mancha;33;17;16
3323;Sotonera, La;Huesca;Aragón;872;469;403
3570;Sotorribas;Cuenca;Castilla-La Mancha;732;378;354
6471;Sotosalbos;Segovia;Castilla y León;120;61;59
3942;Sotoserrano;Salamanca;Castilla y León;573;308;265
5131;Sotragero;Burgos;Castilla y León;273;147;126
4345;Sotresgudo;Burgos;Castilla y León;440;253;187
970;Soutomaior;Pontevedra;Galicia;7395;3677;3718
846;Suances;Cantabria;Cantabria;8782;4314;4468
1756;Subirats;Barcelona;Cataluña;3044;1577;1467
3352;Sudanell;Lleida;Cataluña;853;465;388
284;Sueca;Valencia/València;Comunidad Valenciana;27479;13548;13931
7984;Suellacabras;Soria;Castilla y León;25;15;10
4063;Sueras/Suera;Castellón/Castelló;Comunidad Valenciana;525;279;246
5612;Suflí;Almería;Andalucía;204;109;95
4796;Sukarrieta;Bizkaia;País Vasco;332;169;163
3003;Sumacàrcer;Valencia/València;Comunidad Valenciana;1096;540;556
3690;Sunbilla;Navarra;Navarra;675;347;328
4693;Sunyer;Lleida;Cataluña;352;205;147
1137;Súria;Barcelona;Cataluña;5942;2897;3045
6734;Susinos del Páramo;Burgos;Castilla y León;103;64;39
6771;Susqueda;Girona;Cataluña;101;60;41
6314;Tabanera de Cerrato;Palencia;Castilla y León;135;72;63
7959;Tabanera de Valdavia;Palencia;Castilla y León;27;16;11
7476;Tabanera la Luenga;Segovia;Castilla y León;56;27;29
3535;Tábara;Zamora;Castilla y León;747;383;364
6688;Tabera de Abajo;Salamanca;Castilla y León;106;60;46
1572;Tabernas;Almería;Andalucía;3688;1898;1790
3258;Taberno;Almería;Andalucía;925;450;475
1872;Taboada;Lugo;Galicia;2756;1311;1445
2651;Taboadela;Ourense;Galicia;1429;734;695
4899;Tabuenca;Zaragoza;Aragón;314;181;133
335;Tacoronte;Santa Cruz de Tenerife;Canarias;24134;11990;12144
719;Tafalla;Navarra;Navarra;10595;5224;5371
4842;Tagamanent;Barcelona;Cataluña;323;169;154
3739;Taha, La;Granada;Andalucía;653;337;316
4654;Tahal;Almería;Andalucía;362;177;185
7963;Tajahuerce;Soria;Castilla y León;27;15;12
7321;Tajueco;Soria;Castilla y León;64;35;29
7023;Tala, La;Salamanca;Castilla y León;84;48;36
5600;Talamanca;Barcelona;Cataluña;206;115;91
1521;Talamanca de Jarama;Madrid;Comunidad de Madrid;3857;1906;1951
7324;Talamantes;Zaragoza;Aragón;64;30;34
3913;Talarn;Lleida;Cataluña;585;387;198
1642;Talarrubias;Badajoz;Extremadura;3412;1700;1712
3417;Talaván;Cáceres;Extremadura;814;422;392
5068;Talavera;Lleida;Cataluña;283;158;125
84;Talavera de la Reina;Toledo;Castilla-La Mancha;83417;40081;43336
1239;Talavera la Real;Badajoz;Extremadura;5314;2651;2663
4863;Talaveruela de la Vera;Cáceres;Extremadura;319;169;150
974;Talayuela;Cáceres;Extremadura;7371;3965;3406
3312;Talayuelas;Cuenca;Castilla-La Mancha;878;467;411
3397;Tales;Castellón/Castelló;Comunidad Valenciana;825;416;409
3708;Táliga;Badajoz;Extremadura;665;334;331
4257;Tallada d'Empordà, La;Girona;Cataluña;463;241;222
6710;Talveila;Soria;Castilla y León;105;63;42
6396;Tamajón;Guadalajara;Castilla-La Mancha;126;71;55
3473;Tamames;Salamanca;Castilla y León;781;397;384
7267;Támara de Campos;Palencia;Castilla y León;67;34;33
1627;Tamarite de Litera;Huesca;Aragón;3476;1789;1687
7077;Tamariz de Campos;Valladolid;Castilla y León;80;45;35
7681;Tamarón;Burgos;Castilla y León;43;23;20
5542;Tamurejo;Badajoz;Extremadura;214;113;101
1870;Tanque, El;Santa Cruz de Tenerife;Canarias;2763;1338;1425
1541;Tapia de Casariego;Asturias;Principado de Asturias;3786;1841;1945
6157;Tapioles;Zamora;Castilla y León;150;88;62
1067;Taradell;Barcelona;Cataluña;6489;3238;3251
7601;Taragudo;Guadalajara;Castilla-La Mancha;49;28;21
3808;Taramundi;Asturias;Principado de Asturias;623;297;326
532;Tarancón;Cuenca;Castilla-La Mancha;15271;7550;7721
7769;Taravilla;Guadalajara;Castilla-La Mancha;38;26;12
720;Tarazona;Zaragoza;Aragón;10533;5256;5277
4945;Tarazona de Guareña;Salamanca;Castilla y León;305;166;139
1098;Tarazona de la Mancha;Albacete;Castilla-La Mancha;6235;3197;3038
3752;Tàrbena;Alicante/Alacant;Comunidad Valenciana;646;335;311
5591;Tardáguila;Salamanca;Castilla y León;208;123;85
3485;Tardajos;Burgos;Castilla y León;771;409;362
4391;Tardelcuende;Soria;Castilla y León;431;229;202
3197;Tardienta;Huesca;Aragón;961;477;484
4200;Tariego de Cerrato;Palencia;Castilla y León;481;255;226
455;Tarifa;Cádiz;Andalucía;18162;9152;9010
7586;Taroda;Soria;Castilla y León;50;28;22
48;Tarragona;Tarragona;Cataluña;134515;65505;69010
482;Tàrrega;Lleida;Cataluña;17098;8489;8609
6683;Tarrés;Lleida;Cataluña;106;56;50
5743;Tarroja de Segarra;Lleida;Cataluña;187;104;83
6266;Tartanedo;Guadalajara;Castilla-La Mancha;140;81;59
1021;Tauste;Zaragoza;Aragón;6912;3451;3461
817;Tavernes Blanques;Valencia/València;Comunidad Valenciana;9120;4463;4657
478;Tavernes de la Valldigna;Valencia/València;Comunidad Valenciana;17201;8571;8630
4883;Tavèrnoles;Barcelona;Cataluña;316;159;157
6599;Tavertet;Barcelona;Cataluña;111;57;54
1376;Tazacorte;Santa Cruz de Tenerife;Canarias;4575;2342;2233
1546;Teba;Málaga;Andalucía;3760;1887;1873
5052;Tébar;Cuenca;Castilla-La Mancha;286;146;140
679;Tegueste;Santa Cruz de Tenerife;Canarias;11294;5561;5733
356;Teguise;Palmas, Las;Canarias;22342;11264;11078
1080;Teià;Barcelona;Cataluña;6397;3134;3263
4886;Teixeira, A;Ourense;Galicia;316;159;157
7882;Tejada;Burgos;Castilla y León;31;17;14
6493;Tejadillos;Cuenca;Castilla-La Mancha;118;57;61
6654;Tejado;Soria;Castilla y León;108;62;46
6845;Tejado, El;Salamanca;Castilla y León;96;52;44
2299;Tejeda;Palmas, Las;Canarias;1909;1031;878
3458;Tejeda de Tiétar;Cáceres;Extremadura;788;415;373
6904;Tejeda y Segoyuela;Salamanca;Castilla y León;92;52;40
61;Telde;Palmas, Las;Canarias;102647;50446;52201
5407;Tella-Sin;Huesca;Aragón;232;136;96
2264;Tembleque;Toledo;Castilla-La Mancha;1986;1008;978
4934;Tendilla;Guadalajara;Castilla-La Mancha;307;170;137
6271;Tenebrón;Salamanca;Castilla y León;140;72;68
446;Teo;Coruña, A;Galicia;18579;9127;9452
5340;Teresa;Castellón/Castelló;Comunidad Valenciana;242;128;114
3776;Teresa de Cofrentes;Valencia/València;Comunidad Valenciana;636;329;307
2733;Térmens;Lleida;Cataluña;1333;678;655
618;Teror;Palmas, Las;Canarias;12519;6428;6091
4587;Terque;Almería;Andalucía;377;198;179
4810;Terrades;Girona;Cataluña;329;162;167
1755;Terradillos;Salamanca;Castilla y León;3046;1522;1524
7099;Terradillos de Esgueva;Burgos;Castilla y León;78;37;41
21;Terrassa;Barcelona;Cataluña;220556;108469;112087
5103;Terrateig;Valencia/València;Comunidad Valenciana;278;147;131
4324;Terrer;Zaragoza;Aragón;447;240;207
5800;Terriente;Teruel;Aragón;183;103;80
3683;Terrinches;Ciudad Real;Castilla-La Mancha;678;346;332
7827;Terroba;Rioja, La;La Rioja;34;20;14
203;Teruel;Teruel;Aragón;35890;17080;18810
8003;Terzaga;Guadalajara;Castilla-La Mancha;23;13;10
685;Teulada;Alicante/Alacant;Comunidad Valenciana;11112;5541;5571
2531;Teverga;Asturias;Principado de Asturias;1572;856;716
842;Tiana;Barcelona;Cataluña;8840;4233;4607
409;Tías;Palmas, Las;Canarias;20170;10354;9816
2497;Tibi;Alicante/Alacant;Comunidad Valenciana;1614;851;763
3856;Tiebas-Muruarte de Reta;Navarra;Navarra;606;315;291
5043;Tiedra;Valladolid;Castilla y León;288;139;149
1911;Tielmes;Madrid;Comunidad de Madrid;2650;1353;1297
1471;Tiemblo, El;Ávila;Castilla y León;4109;2086;2023
5764;Tierga;Zaragoza;Aragón;186;101;85
3487;Tierz;Huesca;Aragón;771;390;381
7602;Tierzo;Guadalajara;Castilla-La Mancha;49;30;19
3286;Tiétar;Cáceres;Extremadura;902;481;421
1966;Tijarafe;Santa Cruz de Tenerife;Canarias;2532;1292;1240
1606;Tíjola;Almería;Andalucía;3541;1763;1778
5628;Tinajas;Cuenca;Castilla-La Mancha;201;110;91
1090;Tinajo;Palmas, Las;Canarias;6279;3232;3047
796;Tineo;Asturias;Principado de Asturias;9389;4748;4641
7796;Tinieblas de la Sierra;Burgos;Castilla y León;36;21;15
3460;Tiñosillos;Ávila;Castilla y León;787;405;382
7736;Tirapu;Navarra;Navarra;40;25;15
5830;Tirgo;Rioja, La;La Rioja;180;89;91
4420;Tírig;Castellón/Castelló;Comunidad Valenciana;419;213;206
6355;Tírvia;Lleida;Cataluña;131;63;68
4294;Titaguas;Valencia/València;Comunidad Valenciana;453;238;215
2750;Titulcia;Madrid;Comunidad de Madrid;1313;686;627
7186;Tiurana;Lleida;Cataluña;73;33;40
3290;Tivenys;Tarragona;Cataluña;899;458;441
2508;Tivissa;Tarragona;Cataluña;1602;799;803
6841;Toba, La;Guadalajara;Castilla-La Mancha;96;57;39
7977;Tobar;Burgos;Castilla y León;25;18;7
934;Tobarra;Albacete;Castilla-La Mancha;7684;3931;3753
5553;Tobed;Zaragoza;Aragón;214;112;102
7582;Tobía;Rioja, La;La Rioja;50;30;20
2393;Toboso, El;Toledo;Castilla-La Mancha;1764;874;890
786;Tocina;Sevilla;Andalucía;9501;4700;4801
6083;Todolella;Castellón/Castelló;Comunidad Valenciana;155;92;63
2050;Toén;Ourense;Galicia;2355;1209;1146
6785;Toga;Castellón/Castelló;Comunidad Valenciana;100;52;48
4542;Tojos, Los;Cantabria;Cantabria;387;227;160
7043;Tolbaños;Ávila;Castilla y León;82;45;37
79;Toledo;Toledo;Castilla-La Mancha;84873;40527;44346
7428;Tollos;Alicante/Alacant;Comunidad Valenciana;57;30;27
7630;Tolocirio;Segovia;Castilla y León;47;23;24
418;Tolosa;Gipuzkoa;País Vasco;19667;9502;10165
2182;Tolox;Málaga;Andalucía;2107;1061;1046
6456;Tolva;Huesca;Aragón;121;66;55
311;Tomares;Sevilla;Andalucía;25359;12511;12848
204;Tomelloso;Ciudad Real;Castilla-La Mancha;35873;17745;18128
584;Tomiño;Pontevedra;Galicia;13499;6815;6684
886;Tona;Barcelona;Cataluña;8241;4099;4142
4048;Topas;Salamanca;Castilla y León;530;286;244
2968;Toques;Coruña, A;Galicia;1124;584;540
2805;Torà;Lleida;Cataluña;1255;639;616
4137;Toral de los Guzmanes;León;Castilla y León;500;273;227
2332;Toral de los Vados;León;Castilla y León;1846;907;939
5470;Torás;Castellón/Castelló;Comunidad Valenciana;223;121;102
4431;Tordehumos;Valladolid;Castilla y León;417;224;193
7616;Tordellego;Guadalajara;Castilla-La Mancha;48;27;21
7968;Tordelrábano;Guadalajara;Castilla-La Mancha;26;19;7
476;Tordera;Barcelona;Cataluña;17216;8722;8494
849;Tordesillas;Valladolid;Castilla y León;8750;4417;4333
6900;Tordesilos;Guadalajara;Castilla-La Mancha;92;50;42
4724;Tordillos;Salamanca;Castilla y León;347;186;161
1681;Tordoia;Coruña, A;Galicia;3299;1558;1741
4776;Tordómar;Burgos;Castilla y León;336;186;150
559;Torelló;Barcelona;Cataluña;14347;7137;7210
1731;Toreno;León;Castilla y León;3105;1539;1566
2639;Torija;Guadalajara;Castilla-La Mancha;1448;756;692
6170;Toril;Cáceres;Extremadura;148;96;52
7875;Toril y Masegoso;Teruel;Aragón;32;26;6
4950;Torla-Ordesa;Huesca;Aragón;304;158;146
7400;Torlengua;Soria;Castilla y León;59;33;26
6356;Tormantos;Rioja, La;La Rioja;131;79;52
7727;Tormellas;Ávila;Castilla y León;40;26;14
7914;Tormón;Teruel;Aragón;30;17;13
4755;Tormos;Alicante/Alacant;Comunidad Valenciana;340;163;177
6213;Torms, Els;Lleida;Cataluña;144;77;67
3344;Tornabous;Lleida;Cataluña;858;461;397
6893;Tornadizo, El;Salamanca;Castilla y León;93;52;41
4428;Tornadizos de Ávila;Ávila;Castilla y León;417;212;205
2956;Tornavacas;Cáceres;Extremadura;1132;603;529
3340;Torno, El;Cáceres;Extremadura;860;448;412
5606;Tornos;Teruel;Aragón;206;108;98
852;Toro;Zamora;Castilla y León;8713;4278;4435
5243;Toro, El;Castellón/Castelló;Comunidad Valenciana;256;146;110
3211;Torquemada;Palencia;Castilla y León;954;526;428
6582;Torralba;Cuenca;Castilla-La Mancha;112;67;45
6773;Torralba de Aragón;Huesca;Aragón;101;59;42
1785;Torralba de Calatrava;Ciudad Real;Castilla-La Mancha;2977;1495;1482
7095;Torralba de los Frailes;Zaragoza;Aragón;79;43;36
6094;Torralba de los Sisones;Teruel;Aragón;155;86;69
5575;Torralba de Oropesa;Toledo;Castilla-La Mancha;211;108;103
5886;Torralba de Ribota;Zaragoza;Aragón;174;98;76
7236;Torralba del Pinar;Castellón/Castelló;Comunidad Valenciana;69;32;37
6739;Torralba del Río;Navarra;Navarra;103;55;48
7501;Torralbilla;Zaragoza;Aragón;55;34;21
3453;Torre Alháquime;Cádiz;Andalucía;790;391;399
6044;Torre d'En Besora, la;Castellón/Castelló;Comunidad Valenciana;158;88;70
5826;Torre d'en Doménec, la;Castellón/Castelló;Comunidad Valenciana;180;92;88
6938;Torre de Arcas;Teruel;Aragón;90;44;46
3509;Torre de Cabdella, La;Lleida;Cataluña;760;383;377
1562;Torre de Claramunt, La;Barcelona;Cataluña;3714;1923;1791
4187;Torre de Don Miguel;Cáceres;Extremadura;484;258;226
7310;Torre de Esgueva;Valladolid;Castilla y León;65;33;32
2485;Torre de Esteban Hambrán, La;Toledo;Castilla-La Mancha;1637;828;809
6290;Torre de Fontaubella, La;Tarragona;Cataluña;138;68;70
3140;Torre de Juan Abad;Ciudad Real;Castilla-La Mancha;995;483;512
3847;Torre de l'Espanyol, La;Tarragona;Cataluña;611;311;300
7950;Torre de las Arcas;Teruel;Aragón;28;15;13
2814;Torre de Miguel Sesmero;Badajoz;Extremadura;1250;641;609
7622;Torre de Peñafiel;Valladolid;Castilla y León;48;29;19
4034;Torre de Santa María;Cáceres;Extremadura;534;265;269
2152;Torre del Bierzo;León;Castilla y León;2164;1112;1052
3889;Torre del Burgo;Guadalajara;Castilla-La Mancha;592;314;278
6473;Torre del Compte;Teruel;Aragón;120;58;62
6219;Torre del Valle, La;Zamora;Castilla y León;144;77;67
8116;Torre en Cameros;Rioja, La;La Rioja;10;8;2
6774;Torre la Ribera;Huesca;Aragón;101;53;48
7026;Torre los Negros;Teruel;Aragón;84;44;40
5784;Torre Val de San Pedro;Segovia;Castilla y León;184;98;86
3559;Torre-Cardela;Granada;Andalucía;736;393;343
205;Torre-Pacheco;Murcia;Región de Murcia;35676;18477;17199
4509;Torre-serona;Lleida;Cataluña;397;208;189
5354;Torre, La;Ávila;Castilla y León;239;132;107
7496;Torreadrada;Segovia;Castilla y León;55;28;27
4448;Torrebaja;Valencia/València;Comunidad Valenciana;411;222;189
5077;Torrebesses;Lleida;Cataluña;282;150;132
7985;Torreblacos;Soria;Castilla y León;25;13;12
1197;Torreblanca;Castellón/Castelló;Comunidad Valenciana;5528;2797;2731
1956;Torreblascopedro;Jaén;Andalucía;2546;1292;1254
2719;Torrecaballeros;Segovia;Castilla y León;1347;700;647
3049;Torrecampo;Córdoba;Andalucía;1059;519;540
7058;Torrechiva;Castellón/Castelló;Comunidad Valenciana;81;46;35
4380;Torrecilla de Alcañiz;Teruel;Aragón;433;224;209
5134;Torrecilla de la Abadesa;Valladolid;Castilla y León;273;134;139
5466;Torrecilla de la Jara;Toledo;Castilla-La Mancha;224;119;105
5269;Torrecilla de la Orden;Valladolid;Castilla y León;253;128;125
7818;Torrecilla de la Torre;Valladolid;Castilla y León;35;22;13
3807;Torrecilla de los Ángeles;Cáceres;Extremadura;624;336;288
7259;Torrecilla del Monte;Burgos;Castilla y León;67;38;29
5710;Torrecilla del Pinar;Segovia;Castilla y León;191;103;88
6424;Torrecilla del Rebollar;Teruel;Aragón;124;81;43
4282;Torrecilla en Cameros;Rioja, La;La Rioja;456;252;204
7872;Torrecilla sobre Alesanco;Rioja, La;La Rioja;32;19;13
3044;Torrecillas de la Tiesa;Cáceres;Extremadura;1067;541;526
8065;Torrecuadrada de Molina;Guadalajara;Castilla-La Mancha;18;13;5
7995;Torrecuadradilla;Guadalajara;Castilla-La Mancha;24;14;10
564;Torredelcampo;Jaén;Andalucía;14247;7143;7104
506;Torredembarra;Tarragona;Cataluña;16184;7925;8259
581;Torredonjimeno;Jaén;Andalucía;13696;6734;6962
1368;Torrefarrera;Lleida;Cataluña;4605;2328;2277
3868;Torrefeta i Florejacs;Lleida;Cataluña;602;322;280
6410;Torregalindo;Burgos;Castilla y León;125;80;45
5229;Torregamones;Zamora;Castilla y León;258;134;124
2135;Torregrossa;Lleida;Cataluña;2202;1140;1062
7403;Torrehermosa;Zaragoza;Aragón;59;33;26
5327;Torreiglesias;Segovia;Castilla y León;245;125;120
50;Torrejón de Ardoz;Madrid;Comunidad de Madrid;131376;64749;66627
841;Torrejón de la Calzada;Madrid;Comunidad de Madrid;8872;4385;4487
1414;Torrejón de Velasco;Madrid;Comunidad de Madrid;4382;2181;2201
1213;Torrejón del Rey;Guadalajara;Castilla-La Mancha;5434;2833;2601
3962;Torrejón el Rubio;Cáceres;Extremadura;565;283;282
1800;Torrejoncillo;Cáceres;Extremadura;2935;1439;1496
4749;Torrejoncillo del Rey;Cuenca;Castilla-La Mancha;341;180;161
6145;Torrelacárcel;Teruel;Aragón;151;82;69
1338;Torrelaguna;Madrid;Comunidad de Madrid;4760;2388;2372
3544;Torrelameu;Lleida;Cataluña;743;433;310
7877;Torrelapaja;Zaragoza;Aragón;32;21;11
7842;Torrelara;Burgos;Castilla y León;33;18;15
142;Torrelavega;Cantabria;Cantabria;51494;24302;27192
2654;Torrelavit;Barcelona;Cataluña;1419;723;696
6201;Torrella;Valencia/València;Comunidad Valenciana;146;81;65
5292;Torrellas;Zaragoza;Aragón;250;128;122
2052;Torrelles de Foix;Barcelona;Cataluña;2348;1267;1081
1122;Torrelles de Llobregat;Barcelona;Cataluña;6041;3003;3038
4469;Torrelobatón;Valladolid;Castilla y León;408;216;192
338;Torrelodones;Madrid;Comunidad de Madrid;23717;11465;12252
3719;Torremanzanas/Torre de les Maçanes, la;Alicante/Alacant;Comunidad Valenciana;661;352;309
3205;Torremayor;Badajoz;Extremadura;957;465;492
2112;Torremejía;Badajoz;Extremadura;2250;1163;1087
3873;Torremenga;Cáceres;Extremadura;599;321;278
3440;Torremocha;Cáceres;Extremadura;798;399;399
8036;Torremocha de Jadraque;Guadalajara;Castilla-La Mancha;21;11;10
3104;Torremocha de Jarama;Madrid;Comunidad de Madrid;1019;514;505
6646;Torremocha de Jiloca;Teruel;Aragón;109;63;46
5954;Torremocha del Campo;Guadalajara;Castilla-La Mancha;166;94;72
7732;Torremocha del Pinar;Guadalajara;Castilla-La Mancha;40;19;21
8114;Torremochuela;Guadalajara;Castilla-La Mancha;10;7;3
109;Torremolinos;Málaga;Andalucía;68661;34276;34385
8117;Torremontalbo;Rioja, La;La Rioja;10;7;3
7674;Torremormojón;Palencia;Castilla y León;44;25;19
88;Torrent;Valencia/València;Comunidad Valenciana;82208;40482;41726
5873;Torrent;Girona;Cataluña;175;92;83
2931;Torrente de Cinca;Huesca;Aragón;1154;591;563
1891;Torrenueva;Ciudad Real;Castilla-La Mancha;2702;1357;1345
1901;Torrenueva Costa;Granada;Andalucía;2682;1397;1285
2462;Torreorgaz;Cáceres;Extremadura;1676;819;857
7235;Torrepadre;Burgos;Castilla y León;69;42;27
986;Torreperogil;Jaén;Andalucía;7276;3552;3724
3963;Torrequemada;Cáceres;Extremadura;565;268;297
2665;Torres;Jaén;Andalucía;1406;721;685
3461;Torres de Albánchez;Jaén;Andalucía;787;401;386
5833;Torres de Albarracín;Teruel;Aragón;180;103;77
6990;Torres de Alcanadre;Huesca;Aragón;86;53;33
5275;Torres de Barbués;Huesca;Aragón;252;125;127
2643;Torres de Berrellén;Zaragoza;Aragón;1446;739;707
372;Torres de Cotillas, Las;Murcia;Región de Murcia;21471;10909;10562
926;Torres de la Alameda;Madrid;Comunidad de Madrid;7779;3973;3806
2090;Torres de Segre;Lleida;Cataluña;2277;1179;1098
4459;Torres del Carrizal;Zamora;Castilla y León;410;209;201
6398;Torres del Río;Navarra;Navarra;126;62;64
3775;Torres Torres;Valencia/València;Comunidad Valenciana;637;342;295
3783;Torresandino;Burgos;Castilla y León;634;340;294
6105;Torrescárcela;Valladolid;Castilla y León;154;81;73
5721;Torresmenudas;Salamanca;Castilla y León;190;97;93
5763;Torrevelilla;Teruel;Aragón;186;92;94
85;Torrevieja;Alicante/Alacant;Comunidad Valenciana;83337;41269;42068
3621;Torrico;Toledo;Castilla-La Mancha;709;364;345
7725;Torrijas;Teruel;Aragón;41;19;22
5654;Torrijo de la Cañada;Zaragoza;Aragón;199;116;83
4289;Torrijo del Campo;Teruel;Aragón;455;234;221
587;Torrijos;Toledo;Castilla-La Mancha;13466;6588;6878
3643;Torroella de Fluvià;Girona;Cataluña;694;354;340
660;Torroella de Montgrí;Girona;Cataluña;11645;5900;5745
6165;Torroja del Priorat;Tarragona;Cataluña;149;81;68
475;Torrox;Málaga;Andalucía;17234;8704;8530
8055;Torrubia;Guadalajara;Castilla-La Mancha;19;11;8
7307;Torrubia de Soria;Soria;Castilla y León;65;46;19
5230;Torrubia del Campo;Cuenca;Castilla-La Mancha;257;129;128
7764;Torrubia del Castillo;Cuenca;Castilla-La Mancha;38;24;14
3428;Tortellà;Girona;Cataluña;809;393;416
3068;Tórtola de Henares;Guadalajara;Castilla-La Mancha;1044;571;473
7553;Tórtoles;Ávila;Castilla y León;51;30;21
4315;Tórtoles de Esgueva;Burgos;Castilla y León;448;237;211
223;Tortosa;Tarragona;Cataluña;33372;16496;16876
5687;Tortuera;Guadalajara;Castilla-La Mancha;194;103;91
8066;Tortuero;Guadalajara;Castilla-La Mancha;18;13;5
3745;Torvizcón;Granada;Andalucía;648;349;299
7505;Tosantos;Burgos;Castilla y León;54;30;24
5906;Toses;Girona;Cataluña;171;102;69
5804;Tosos;Zaragoza;Aragón;183;104;79
1175;Tossa de Mar;Girona;Cataluña;5683;2861;2822
3536;Totalán;Málaga;Andalucía;746;380;366
232;Totana;Murcia;Región de Murcia;32008;16455;15553
4718;Totanés;Toledo;Castilla-La Mancha;348;172;176
1596;Touro;Coruña, A;Galicia;3574;1780;1794
2795;Tous;Valencia/València;Comunidad Valenciana;1263;638;625
2978;Trabada;Lugo;Galicia;1118;546;572
4671;Trabadelo;León;Castilla y León;357;195;162
5783;Trabanca;Salamanca;Castilla y León;184;90;94
3315;Trabazos;Zamora;Castilla y León;878;467;411
5294;Tragacete;Cuenca;Castilla-La Mancha;249;139;110
8004;Traíd;Guadalajara;Castilla-La Mancha;23;15;8
2683;Traiguera;Castellón/Castelló;Comunidad Valenciana;1378;695;683
7205;Tramacastiel;Teruel;Aragón;72;42;30
6743;Tramacastilla;Teruel;Aragón;103;52;51
6718;Tramaced;Huesca;Aragón;104;66;38
3812;Trasierra;Badajoz;Extremadura;622;328;294
2771;Trasmiras;Ourense;Galicia;1286;651;635
7000;Trasmoz;Zaragoza;Aragón;86;51;35
6452;Trasobares;Zaragoza;Aragón;122;76;46
2990;Traspinedo;Valladolid;Castilla y León;1109;592;517
1730;Trazo;Coruña, A;Galicia;3113;1538;1575
1009;Trebujena;Cádiz;Andalucía;7028;3501;3527
5732;Trefacio;Zamora;Castilla y León;189;99;90
7690;Tremedal de Tormes;Salamanca;Castilla y León;43;22;21
1153;Tremp;Lleida;Cataluña;5844;2884;2960
151;Tres Cantos;Madrid;Comunidad de Madrid;47722;23141;24581
3956;Tres Villas, Las;Almería;Andalucía;568;307;261
3035;Trescasas;Segovia;Castilla y León;1071;550;521
5010;Tresjuncos;Cuenca;Castilla-La Mancha;293;155;138
3468;Trespaderne;Burgos;Castilla y León;783;394;389
7342;Tresviso;Cantabria;Cantabria;62;44;18
7693;Trévago;Soria;Castilla y León;43;18;25
3571;Trevélez;Granada;Andalucía;732;383;349
6103;Treviana;Rioja, La;La Rioja;154;81;73
3767;Triacastela;Lugo;Galicia;641;317;324
6661;Tribaldos;Cuenca;Castilla-La Mancha;107;57;50
4574;Tricio;Rioja, La;La Rioja;380;182;198
930;Trigueros;Huelva;Andalucía;7713;3849;3864
4898;Trigueros del Valle;Valladolid;Castilla y León;314;172;142
2866;Trijueque;Guadalajara;Castilla-La Mancha;1201;636;565
2742;Trillo;Guadalajara;Castilla-La Mancha;1319;690;629
7268;Triollo;Palencia;Castilla y León;67;36;31
7275;Tronchón;Teruel;Aragón;67;33;34
4338;Truchas;León;Castilla y León;443;231;212
4134;Trucios-Turtzioz;Bizkaia;País Vasco;501;265;236
2674;Trujillanos;Badajoz;Extremadura;1387;710;677
830;Trujillo;Cáceres;Extremadura;9012;4394;4618
6312;Tubilla del Agua;Burgos;Castilla y León;135;83;52
5967;Tubilla del Lago;Burgos;Castilla y León;164;89;75
6250;Tudanca;Cantabria;Cantabria;141;99;42
200;Tudela;Navarra;Navarra;36258;17840;18418
862;Tudela de Duero;Valladolid;Castilla y León;8564;4366;4198
4660;Tudelilla;Rioja, La;La Rioja;361;198;163
2980;Tuéjar;Valencia/València;Comunidad Valenciana;1116;591;525
492;Tui;Pontevedra;Galicia;16701;8046;8655
536;Tuineje;Palmas, Las;Canarias;15241;7811;7430
6380;Tulebras;Navarra;Navarra;128;51;77
3145;Turcia;León;Castilla y León;993;509;484
3161;Turégano;Segovia;Castilla y León;979;489;490
1046;Turís;Valencia/València;Comunidad Valenciana;6646;3480;3166
3531;Turleque;Toledo;Castilla-La Mancha;749;377;372
5357;Turón;Granada;Andalucía;239;142;97
1602;Turre;Almería;Andalucía;3549;1819;1730
5348;Turrillas;Almería;Andalucía;240;138;102
215;Úbeda;Jaén;Andalucía;34345;16813;17532
6020;Ubide;Bizkaia;País Vasco;160;83;77
494;Ubrique;Cádiz;Andalucía;16597;8203;8394
5781;Ucar;Navarra;Navarra;184;102;82
1928;Uceda;Guadalajara;Castilla-La Mancha;2616;1358;1258
7587;Ucero;Soria;Castilla y León;50;26;24
5479;Uclés;Cuenca;Castilla-La Mancha;222;117;105
3245;Udías;Cantabria;Cantabria;934;472;462
1459;Ugao-Miraballes;Bizkaia;País Vasco;4152;2101;2051
1218;Ugena;Toledo;Castilla-La Mancha;5411;2793;2618
1972;Ugíjar;Granada;Andalucía;2523;1253;1270
3435;Uharte Arakil;Navarra;Navarra;805;429;376
7942;Ujados;Guadalajara;Castilla-La Mancha;28;16;12
5813;Ujué/Uxue;Navarra;Navarra;182;104;78
3319;Ulea;Murcia;Región de Murcia;874;453;421
3382;Uleila del Campo;Almería;Andalucía;833;418;415
2935;Ullà;Girona;Cataluña;1153;632;521
2189;Ullastrell;Barcelona;Cataluña;2093;1052;1041
5028;Ullastret;Girona;Cataluña;290;140;150
1087;Ulldecona;Tarragona;Cataluña;6300;3286;3014
4513;Ulldemolins;Tarragona;Cataluña;396;229;167
5471;Ultramort;Girona;Cataluña;223;118;105
2476;Ultzama;Navarra;Navarra;1653;851;802
840;Umbrete;Sevilla;Andalucía;8894;4452;4442
6799;Umbrías;Ávila;Castilla y León;99;53;46
3778;Uncastillo;Zaragoza;Aragón;636;301;335
5572;Unciti;Navarra;Navarra;211;120;91
7592;Undués de Lerda;Zaragoza;Aragón;50;28;22
5442;Unión de Campos, La;Valladolid;Castilla y León;228;117;111
404;Unión, La;Murcia;Región de Murcia;20225;10271;9954
6214;Unzué/Untzue;Navarra;Navarra;144;78;66
7046;Uña;Cuenca;Castilla-La Mancha;82;43;39
6337;Uña de Quintana;Zamora;Castilla y León;133;72;61
7171;Úrbel del Castillo;Burgos;Castilla y León;74;50;24
1970;Urda;Toledo;Castilla-La Mancha;2529;1262;1267
4711;Urdazubi/Urdax;Navarra;Navarra;349;170;179
3740;Urdiain;Navarra;Navarra;653;335;318
4107;Urdiales del Páramo;León;Castilla y León;510;272;238
1397;Urduliz;Bizkaia;País Vasco;4456;2236;2220
1436;Urduña/Orduña;Bizkaia;País Vasco;4232;2195;2037
2692;Urkabustaiz;Araba/Álava;País Vasco;1371;716;655
1108;Urnieta;Gipuzkoa;País Vasco;6168;3088;3080
6629;Urones de Castroponce;Valladolid;Castilla y León;110;64;46
4702;Urrácal;Almería;Andalucía;350;182;168
6333;Urraul Alto;Navarra;Navarra;133;87;46
4850;Urraul Bajo;Navarra;Navarra;322;140;182
4370;Urrea de Gaén;Teruel;Aragón;435;218;217
4427;Urrea de Jalón;Zaragoza;Aragón;418;234;184
1033;Urretxu;Gipuzkoa;País Vasco;6756;3327;3429
7760;Urriés;Zaragoza;Aragón;39;21;18
5795;Urroz;Navarra;Navarra;183;103;80
4590;Urroz-Villa;Navarra;Navarra;377;194;183
5817;Urueña;Valladolid;Castilla y León;182;102;80
6691;Urueñas;Segovia;Castilla y León;106;65;41
3168;Uruñuela;Rioja, La;La Rioja;976;489;487
5726;Urús;Girona;Cataluña;189;93;96
7020;Urzainqui/Urzainki;Navarra;Navarra;84;54;30
2394;Usagre;Badajoz;Extremadura;1763;873;890
5153;Used;Zaragoza;Aragón;269;145;124
3194;Useras/Useres, les;Castellón/Castelló;Comunidad Valenciana;962;500;462
1107;Usurbil;Gipuzkoa;País Vasco;6174;3090;3084
7883;Utande;Guadalajara;Castilla-La Mancha;31;23;8
441;Utebo;Zaragoza;Aragón;18691;9287;9404
6114;Uterga;Navarra;Navarra;153;88;65
666;Utiel;Valencia/València;Comunidad Valenciana;11531;5763;5768
146;Utrera;Sevilla;Andalucía;50728;25161;25567
1784;Utrillas;Teruel;Aragón;2978;1545;1433
6139;Uztárroz/Uztarroze;Navarra;Navarra;151;79;72
1043;Vacarisses;Barcelona;Cataluña;6688;3436;3252
6849;Vadillo;Soria;Castilla y León;96;50;46
5312;Vadillo de la Guareña;Zamora;Castilla y León;248;132;116
7376;Vadillo de la Sierra;Ávila;Castilla y León;60;39;21
4686;Vadocondes;Burgos;Castilla y León;353;200;153
6946;Vajol, La;Girona;Cataluña;89;48;41
4125;Val de San Lorenzo;León;Castilla y León;505;253;252
7294;Val de San Martín;Zaragoza;Aragón;66;39;27
1878;Val de San Vicente;Cantabria;Cantabria;2728;1403;1325
1515;Val do Dubra;Coruña, A;Galicia;3876;1854;2022
8031;Valacloche;Teruel;Aragón;22;12;10
2260;Valadouro, O;Lugo;Galicia;1991;957;1034
5950;Valbona;Teruel;Aragón;167;93;74
4245;Valbuena de Duero;Valladolid;Castilla y León;468;252;216
7629;Valbuena de Pisuerga;Palencia;Castilla y León;47;25;22
4612;Valcabado;Zamora;Castilla y León;372;191;181
2144;Valdáliga;Cantabria;Cantabria;2182;1129;1053
3849;Valdaracete;Madrid;Comunidad de Madrid;609;313;296
7733;Valdarachas;Guadalajara;Castilla-La Mancha;40;20;20
4851;Valdastillas;Cáceres;Extremadura;321;166;155
6922;Valde-Ucieza;Palencia;Castilla y León;91;55;36
3841;Valdealgorfa;Teruel;Aragón;612;301;311
6677;Valdeande;Burgos;Castilla y León;106;62;44
7452;Valdearcos de la Vega;Valladolid;Castilla y León;57;31;26
7134;Valdearenas;Guadalajara;Castilla-La Mancha;76;52;24
6548;Valdeavellano;Guadalajara;Castilla-La Mancha;114;62;52
5711;Valdeavellano de Tera;Soria;Castilla y León;191;104;87
2546;Valdeavero;Madrid;Comunidad de Madrid;1554;806;748
3034;Valdeaveruelo;Guadalajara;Castilla-La Mancha;1072;558;514
3025;Valdecaballeros;Badajoz;Extremadura;1077;558;519
6618;Valdecañas de Tajo;Cáceres;Extremadura;110;59;51
4768;Valdecarros;Salamanca;Castilla y León;338;171;167
7353;Valdecasa;Ávila;Castilla y León;61;36;25
7200;Valdecolmenas, Los;Cuenca;Castilla-La Mancha;72;47;25
7734;Valdeconcha;Guadalajara;Castilla-La Mancha;40;22;18
7831;Valdecuenca;Teruel;Aragón;34;20;14
7500;Valdefinjas;Zamora;Castilla y León;55;33;22
2141;Valdefresno;León;Castilla y León;2187;1131;1056
2899;Valdefuentes;Cáceres;Extremadura;1174;577;597
5677;Valdefuentes de Sangusín;Salamanca;Castilla y León;196;110;86
4853;Valdefuentes del Páramo;León;Castilla y León;321;171;150
2231;Valdeganga;Albacete;Castilla-La Mancha;2028;1038;990
7774;Valdegeña;Soria;Castilla y León;38;28;10
3137;Valdegovía/Gaubea;Araba/Álava;País Vasco;996;553;443
7465;Valdegrudas;Guadalajara;Castilla-La Mancha;56;35;21
7088;Valdehijaderos;Salamanca;Castilla y León;79;42;37
7863;Valdehorna;Zaragoza;Aragón;33;18;15
5872;Valdehúncar;Cáceres;Extremadura;175;95;80
1885;Valdelacalzada;Badajoz;Extremadura;2711;1384;1327
5538;Valdelacasa;Salamanca;Castilla y León;215;125;90
4713;Valdelacasa de Tajo;Cáceres;Extremadura;348;184;164
7139;Valdelageve;Salamanca;Castilla y León;76;39;37
8070;Valdelagua del Cerro;Soria;Castilla y León;18;11;7
3239;Valdelaguna;Madrid;Comunidad de Madrid;937;469;468
5359;Valdelarco;Huelva;Andalucía;239;112;127
7658;Valdelcubo;Guadalajara;Castilla-La Mancha;45;31;14
6972;Valdelinares;Teruel;Aragón;88;54;34
4466;Valdelosa;Salamanca;Castilla y León;409;203;206
5071;Valdeltormo;Teruel;Aragón;283;136;147
4111;Valdelugueros;León;Castilla y León;508;290;218
8123;Valdemadera;Rioja, La;La Rioja;8;5;3
6144;Valdemaluque;Soria;Castilla y León;151;68;83
3280;Valdemanco;Madrid;Comunidad de Madrid;914;480;434
5912;Valdemanco del Esteras;Ciudad Real;Castilla-La Mancha;170;90;80
3472;Valdemaqueda;Madrid;Comunidad de Madrid;781;405;376
7016;Valdemeca;Cuenca;Castilla-La Mancha;84;47;37
7331;Valdemierque;Salamanca;Castilla y León;63;40;23
7049;Valdemora;León;Castilla y León;82;36;46
5639;Valdemorales;Cáceres;Extremadura;200;98;102
619;Valdemorillo;Madrid;Comunidad de Madrid;12518;6306;6212
7390;Valdemorillo de la Sierra;Cuenca;Castilla-La Mancha;59;35;24
99;Valdemoro;Madrid;Comunidad de Madrid;75983;37493;38490
6619;Valdemoro-Sierra;Cuenca;Castilla-La Mancha;110;65;45
6692;Valdenebro;Soria;Castilla y León;106;59;47
5704;Valdenebro de los Valles;Valladolid;Castilla y León;192;102;90
5232;Valdenuño Fernández;Guadalajara;Castilla-La Mancha;257;140;117
3733;Valdeobispo;Cáceres;Extremadura;656;322;334
3226;Valdeolea;Cantabria;Cantabria;947;502;445
5622;Valdeolivas;Cuenca;Castilla-La Mancha;202;125;77
7444;Valdeolmillos;Palencia;Castilla y León;57;32;25
1462;Valdeolmos-Alalpardo;Madrid;Comunidad de Madrid;4136;2130;2006
254;Valdepeñas;Ciudad Real;Castilla-La Mancha;30077;14644;15433
1564;Valdepeñas de Jaén;Jaén;Andalucía;3714;1841;1873
6124;Valdepeñas de la Sierra;Guadalajara;Castilla-La Mancha;152;90;62
4736;Valdepiélago;León;Castilla y León;344;197;147
3917;Valdepiélagos;Madrid;Comunidad de Madrid;584;315;269
2851;Valdepolo;León;Castilla y León;1219;654;565
8124;Valdeprado;Soria;Castilla y León;8;5;3
4771;Valdeprado del Río;Cantabria;Cantabria;337;188;149
7270;Valdeprados;Segovia;Castilla y León;67;37;30
2493;Valderas;León;Castilla y León;1623;822;801
7581;Valderrábano;Palencia;Castilla y León;50;27;23
8005;Valderrebollo;Guadalajara;Castilla-La Mancha;23;12;11
3150;Valderredible;Cantabria;Cantabria;989;555;434
4328;Valderrey;León;Castilla y León;446;224;222
2015;Valderrobres;Teruel;Aragón;2425;1240;1185
7254;Valderrodilla;Soria;Castilla y León;68;36;32
6155;Valderrodrigo;Salamanca;Castilla y León;150;74;76
2193;Valderrubio;Granada;Andalucía;2086;1024;1062
3385;Valderrueda;León;Castilla y León;832;438;394
671;Valdés;Asturias;Principado de Asturias;11504;5619;5885
5688;Valdesamario;León;Castilla y León;194;109;85
6415;Valdescorriel;Zamora;Castilla y León;125;61;64
7969;Valdesotos;Guadalajara;Castilla-La Mancha;26;17;9
2483;Valdestillas;Valladolid;Castilla y León;1643;851;792
2902;Valdetorres;Badajoz;Extremadura;1173;573;600
1386;Valdetorres de Jarama;Madrid;Comunidad de Madrid;4497;2277;2220
6331;Valdetórtola;Cuenca;Castilla-La Mancha;133;75;58
7911;Valdevacas de Montejo;Segovia;Castilla y León;30;15;15
6806;Valdevacas y Guijar;Segovia;Castilla y León;99;53;46
3966;Valdeverdeja;Toledo;Castilla-La Mancha;564;280;284
3163;Valdevimbre;León;Castilla y León;978;505;473
6241;Valdezate;Burgos;Castilla y León;142;81;61
1804;Valdilecha;Madrid;Comunidad de Madrid;2933;1517;1416
4900;Valdorros;Burgos;Castilla y León;313;179;134
1057;Valdoviño;Coruña, A;Galicia;6563;3181;3382
6822;Valdunciel;Salamanca;Castilla y León;98;49;49
6189;Valdunquillo;Valladolid;Castilla y León;147;72;75
3;València;Valencia/València;Comunidad Valenciana;794288;377504;416784
1224;Valencia de Alcántara;Cáceres;Extremadura;5397;2643;2754
1232;Valencia de Don Juan;León;Castilla y León;5351;2628;2723
3965;Valencia de las Torres;Badajoz;Extremadura;564;296;268
3541;Valencia del Mombuey;Badajoz;Extremadura;744;379;365
2272;Valencia del Ventoso;Badajoz;Extremadura;1973;975;998
929;Valencina de la Concepción;Sevilla;Andalucía;7751;3792;3959
2959;Valenzuela;Córdoba;Andalucía;1131;562;569
3658;Valenzuela de Calatrava;Ciudad Real;Castilla-La Mancha;688;321;367
2593;Valeras, Las;Cuenca;Castilla-La Mancha;1496;789;707
4807;Valero;Salamanca;Castilla y León;330;180;150
7264;Valfarta;Huesca;Aragón;67;41;26
7381;Valfermoso de Tajuña;Guadalajara;Castilla-La Mancha;60;41;19
1150;Valga;Pontevedra;Galicia;5869;2890;2979
6400;Valgañón;Rioja, La;La Rioja;126;77;49
8006;Valhermoso;Guadalajara;Castilla-La Mancha;23;12;11
7436;Valhermoso de la Fuente;Cuenca;Castilla-La Mancha;57;30;27
4808;Valjunquera;Teruel;Aragón;330;171;159
1851;Vall d'Alba;Castellón/Castelló;Comunidad Valenciana;2807;1468;1339
5943;Vall d'Alcalà, la;Alicante/Alacant;Comunidad Valenciana;167;92;75
5523;Vall d'Ebo, la;Alicante/Alacant;Comunidad Valenciana;216;111;105
1744;Vall d'en Bas, La;Girona;Cataluña;3072;1553;1519
236;Vall d'Uixó, la;Castellón/Castelló;Comunidad Valenciana;31660;15631;16029
5151;Vall de Almonacid;Castellón/Castelló;Comunidad Valenciana;269;133;136
2793;Vall de Bianya, La;Girona;Cataluña;1264;639;625
3100;Vall de Boí, La;Lleida;Cataluña;1021;546;475
4646;Vall de Cardós;Lleida;Cataluña;364;195;169
3949;Vall de Gallinera;Alicante/Alacant;Comunidad Valenciana;571;304;267
3361;Vall de Laguar, la;Alicante/Alacant;Comunidad Valenciana;846;427;419
3289;Vall-llobrega;Girona;Cataluña;899;446;453
1759;Vallada;Valencia/València;Comunidad Valenciana;3039;1544;1495
13;Valladolid;Valladolid;Castilla y León;298412;140059;158353
6285;Vallanca;Valencia/València;Comunidad Valenciana;139;76;63
7703;Vallarta de Bureba;Burgos;Castilla y León;42;26;16
7596;Vallat;Castellón/Castelló;Comunidad Valenciana;49;21;28
2687;Vallbona d'Anoia;Barcelona;Cataluña;1373;719;654
5398;Vallbona de les Monges;Lleida;Cataluña;233;120;113
5289;Vallcebre;Barcelona;Cataluña;250;142;108
6825;Vallclara;Tarragona;Cataluña;98;57;41
2274;Valldemossa;Balears, Illes;Islas Baleares;1969;991;978
1961;Valle de Abdalajís;Málaga;Andalucía;2542;1292;1250
5567;Valle de Altomira, El;Cuenca;Castilla-La Mancha;211;117;94
7905;Valle de Bardají;Huesca;Aragón;30;18;12
6933;Valle de Cerrato;Palencia;Castilla y León;90;53;37
378;Valle de Egüés/Eguesibar;Navarra;Navarra;21128;10611;10517
3402;Valle de Hecho;Huesca;Aragón;822;428;394
2874;Valle de la Serena;Badajoz;Extremadura;1191;600;591
4081;Valle de las Navas;Burgos;Castilla y León;520;302;218
7751;Valle de Lierp;Huesca;Aragón;39;20;19
4169;Valle de Losa;Burgos;Castilla y León;490;291;199
6468;Valle de Manzanedo;Burgos;Castilla y León;120;66;54
4631;Valle de Matamoros;Badajoz;Extremadura;367;179;188
1557;Valle de Mena;Burgos;Castilla y León;3726;1906;1820
5976;Valle de Oca;Burgos;Castilla y León;163;98;65
4416;Valle de Ollo/Ollaran;Navarra;Navarra;421;233;188
2945;Valle de Santa Ana;Badajoz;Extremadura;1139;559;580
4135;Valle de Santibáñez;Burgos;Castilla y León;500;282;218
4365;Valle de Sedano;Burgos;Castilla y León;436;246;190
6998;Valle de Tabladillo;Segovia;Castilla y León;86;51;35
3208;Valle de Tobalina;Burgos;Castilla y León;954;516;438
650;Valle de Trápaga-Trapagaran;Bizkaia;País Vasco;11985;5826;6159
4226;Valle de Valdebezana;Burgos;Castilla y León;475;247;228
5741;Valle de Valdelaguna;Burgos;Castilla y León;187;111;76
4827;Valle de Valdelucio;Burgos;Castilla y León;326;179;147
5065;Valle de Villaverde;Cantabria;Cantabria;283;154;129
2580;Valle de Yerri/Deierri;Navarra;Navarra;1506;790;716
7281;Valle de Zamanzas;Burgos;Castilla y León;66;36;30
5969;Valle del Retortillo;Palencia;Castilla y León;164;98;66
2174;Valle del Zalabí;Granada;Andalucía;2128;1083;1045
1377;Valle Gran Rey;Santa Cruz de Tenerife;Canarias;4564;2301;2263
3279;Valle, El;Granada;Andalucía;914;455;459
6379;Vallecillo;León;Castilla y León;128;78;50
7632;Vallecillo, El;Teruel;Aragón;47;27;20
1816;Vallehermoso;Santa Cruz de Tenerife;Canarias;2901;1505;1396
7682;Vallejera;Burgos;Castilla y León;43;24;19
7189;Vallejera de Riofrío;Salamanca;Castilla y León;73;33;40
3644;Vallelado;Segovia;Castilla y León;694;368;326
7219;Valleruela de Pedraza;Segovia;Castilla y León;71;37;34
7566;Valleruela de Sepúlveda;Segovia;Castilla y León;51;25;26
6066;Vallés;Valencia/València;Comunidad Valenciana;157;84;73
7055;Valles de Palenzuela;Burgos;Castilla y León;81;42;39
7038;Vallesa de la Guareña;Zamora;Castilla y León;83;45;38
1549;Valleseco;Palmas, Las;Canarias;3749;1964;1785
2315;Vallfogona de Balaguer;Lleida;Cataluña;1876;937;939
5601;Vallfogona de Ripollès;Girona;Cataluña;206;109;97
6926;Vallfogona de Riucorb;Tarragona;Cataluña;91;55;36
1819;Vallgorguina;Barcelona;Cataluña;2891;1451;1440
7237;Vallibona;Castellón/Castelló;Comunidad Valenciana;69;39;30
542;Vallirana;Barcelona;Cataluña;15006;7523;7483
2405;Vallmoll;Tarragona;Cataluña;1756;890;866
1948;Vallromanes;Barcelona;Cataluña;2579;1328;1251
325;Valls;Tarragona;Cataluña;24359;12210;12149
5214;Valls d'Aguilar, Les;Lleida;Cataluña;260;145;115
3451;Valls de Valira, Les;Lleida;Cataluña;791;412;379
7198;Valluércanes;Burgos;Castilla y León;72;46;26
6517;Valmadrid;Zaragoza;Aragón;117;71;46
7933;Valmala;Burgos;Castilla y León;28;14;14
1422;Valmojado;Toledo;Castilla-La Mancha;4303;2162;2141
3688;Válor;Granada;Andalucía;675;347;328
3798;Valoria la Buena;Valladolid;Castilla y León;629;339;290
6275;Valpalmas;Zaragoza;Aragón;140;68;72
6208;Valsalabroso;Salamanca;Castilla y León;145;82;63
8001;Valsalobre;Cuenca;Castilla-La Mancha;23;12;11
5402;Valseca;Segovia;Castilla y León;233;129;104
4676;Valsequillo;Córdoba;Andalucía;356;168;188
799;Valsequillo de Gran Canaria;Palmas, Las;Canarias;9340;4689;4651
8128;Valtablado del Río;Guadalajara;Castilla-La Mancha;7;4;3
8059;Valtajeros;Soria;Castilla y León;19;13;6
6966;Valtiendas;Segovia;Castilla y León;88;51;37
2023;Valtierra;Navarra;Navarra;2412;1216;1196
7374;Valtorres;Zaragoza;Aragón;61;27;34
1301;Valverde;Santa Cruz de Tenerife;Canarias;5005;2511;2494
4254;Valverde de Alcalá;Madrid;Comunidad de Madrid;465;239;226
5128;Valverde de Burguillos;Badajoz;Extremadura;273;145;128
6865;Valverde de Campos;Valladolid;Castilla y León;95;56;39
3016;Valverde de Júcar;Cuenca;Castilla-La Mancha;1082;534;548
4191;Valverde de la Vera;Cáceres;Extremadura;483;249;234
980;Valverde de la Virgen;León;Castilla y León;7328;3777;3551
1457;Valverde de Leganés;Badajoz;Extremadura;4159;2093;2066
3911;Valverde de Llerena;Badajoz;Extremadura;585;293;292
6874;Valverde de los Arroyos;Guadalajara;Castilla-La Mancha;94;48;46
3053;Valverde de Mérida;Badajoz;Extremadura;1055;535;520
7218;Valverde de Valdelacasa;Salamanca;Castilla y León;71;38;33
611;Valverde del Camino;Huelva;Andalucía;12820;6311;6509
2074;Valverde del Fresno;Cáceres;Extremadura;2309;1164;1145
3007;Valverde del Majano;Segovia;Castilla y León;1095;566;529
6086;Valverde-Enrique;León;Castilla y León;155;78;77
6887;Valverdejo;Cuenca;Castilla-La Mancha;93;51;42
5057;Valverdón;Salamanca;Castilla y León;285;151;134
1068;Vandellòs i l'Hospitalet de l'Infant;Tarragona;Cataluña;6482;3246;3236
6010;Vansa i Fórnols, La;Lleida;Cataluña;161;84;77
4149;Vara de Rey;Cuenca;Castilla-La Mancha;496;254;242
5807;Veciana;Barcelona;Cataluña;182;99;83
4545;Vecilla, La;León;Castilla y León;386;206;180
5268;Vecinos;Salamanca;Castilla y León;253;124;129
1296;Vedra;Coruña, A;Galicia;5036;2475;2561
2201;Vega de Espinareda;León;Castilla y León;2069;1054;1015
3351;Vega de Infanzones;León;Castilla y León;854;436;418
3558;Vega de Liébana;Cantabria;Cantabria;736;387;349
3502;Vega de Pas;Cantabria;Cantabria;763;403;360
6940;Vega de Ruiponce;Valladolid;Castilla y León;90;53;37
946;Vega de San Mateo;Palmas, Las;Canarias;7556;3905;3651
7028;Vega de Santa María;Ávila;Castilla y León;83;41;42
4817;Vega de Tera;Zamora;Castilla y León;328;156;172
5980;Vega de Tirados;Salamanca;Castilla y León;163;91;72
3854;Vega de Valcarce;León;Castilla y León;606;317;289
6501;Vega de Valdetronco;Valladolid;Castilla y León;118;64;54
6809;Vega de Villalobos;Zamora;Castilla y León;99;44;55
6368;Vega del Codorno;Cuenca;Castilla-La Mancha;129;80;49
5096;Vegacervera;León;Castilla y León;279;144;135
1504;Vegadeo;Asturias;Principado de Asturias;3926;1884;2042
6973;Vegalatrave;Zamora;Castilla y León;88;45;43
5506;Veganzones;Segovia;Castilla y León;219;118;101
4351;Vegaquemada;León;Castilla y León;439;244;195
5133;Vegas de Matute;Segovia;Castilla y León;273;161;112
2983;Vegas del Condado;León;Castilla y León;1114;650;464
684;Vegas del Genil;Granada;Andalucía;11166;5704;5462
3336;Vegaviana;Cáceres;Extremadura;864;444;420
8061;Veguillas de la Sierra;Teruel;Aragón;19;12;7
5081;Veguillas, Las;Salamanca;Castilla y León;281;137;144
3297;Veiga, A;Ourense;Galicia;889;453;436
616;Vejer de la Frontera;Cádiz;Andalucía;12624;6289;6335
1813;Velada;Toledo;Castilla-La Mancha;2910;1506;1404
7140;Velamazán;Soria;Castilla y León;76;50;26
5985;Velascálvaro;Valladolid;Castilla y León;163;90;73
5566;Velayos;Ávila;Castilla y León;211;109;102
5338;Velefique;Almería;Andalucía;242;133;109
1836;Vélez de Benaudalla;Granada;Andalucía;2841;1414;1427
2300;Vélez-Blanco;Almería;Andalucía;1904;981;923
90;Vélez-Málaga;Málaga;Andalucía;81643;40239;41404
1059;Vélez-Rubio;Almería;Andalucía;6555;3207;3348
6630;Velilla;Valladolid;Castilla y León;110;54;56
4265;Velilla de Cinca;Huesca;Aragón;461;244;217
5541;Velilla de Ebro;Zaragoza;Aragón;215;116;99
6984;Velilla de Jiloca;Zaragoza;Aragón;87;42;45
7999;Velilla de la Sierra;Soria;Castilla y León;24;15;9
8050;Velilla de los Ajos;Soria;Castilla y León;20;10;10
635;Velilla de San Antonio;Madrid;Comunidad de Madrid;12236;6178;6058
2788;Velilla del Río Carrión;Palencia;Castilla y León;1268;653;615
4026;Vellés, La;Salamanca;Castilla y León;537;297;240
6757;Vellisca;Cuenca;Castilla-La Mancha;102;59;43
6502;Velliza;Valladolid;Castilla y León;118;74;44
2281;Vellón, El;Madrid;Comunidad de Madrid;1958;1022;936
4533;Vencillón;Huesca;Aragón;389;207;182
192;Vendrell, El;Tarragona;Cataluña;37606;18631;18975
4339;Venialbo;Zamora;Castilla y León;443;242;201
1082;Venta de Baños;Palencia;Castilla y León;6360;3199;3161
2856;Venta del Moro;Valencia/València;Comunidad Valenciana;1207;644;563
3341;Ventalló;Girona;Cataluña;859;438;421
2989;Ventas con Peña Aguilera, Las;Toledo;Castilla-La Mancha;1109;569;540
3768;Ventas de Huelma;Granada;Andalucía;640;350;290
1659;Ventas de Retamosa, Las;Toledo;Castilla-La Mancha;3365;1768;1597
5440;Ventas de San Julián, Las;Toledo;Castilla-La Mancha;228;111;117
6035;Ventosa;Rioja, La;La Rioja;159;83;76
6745;Ventosa de la Cuesta;Valladolid;Castilla y León;103;61;42
6689;Ventosa del Río Almar;Salamanca;Castilla y León;106;60;46
8056;Ventosilla y Tejadilla;Segovia;Castilla y León;19;13;6
7471;Ventrosa;Rioja, La;La Rioja;56;32;24
2153;Venturada;Madrid;Comunidad de Madrid;2163;1135;1028
499;Vera;Almería;Andalucía;16452;8396;8056
4769;Vera de Moncayo;Zaragoza;Aragón;338;174;164
3271;Verdú;Lleida;Cataluña;919;441;478
3230;Verea;Ourense;Galicia;943;453;490
1360;Verger, el;Alicante/Alacant;Comunidad Valenciana;4640;2302;2338
2904;Verges;Girona;Cataluña;1171;572;599
578;Verín;Ourense;Galicia;13723;6580;7143
5839;Vertavillo;Palencia;Castilla y León;179;97;82
4457;Vespella de Gaià;Tarragona;Cataluña;410;232;178
4313;Vezdemarbán;Zamora;Castilla y León;449;230;219
7800;Viacamp y Litera;Huesca;Aragón;36;24;12
1441;Viana;Navarra;Navarra;4209;2130;2079
2229;Viana de Cega;Valladolid;Castilla y León;2032;1054;978
7511;Viana de Duero;Soria;Castilla y León;54;39;15
7644;Viana de Jadraque;Guadalajara;Castilla-La Mancha;46;32;14
1821;Viana do Bolo;Ourense;Galicia;2886;1458;1428
5455;Viandar de la Vera;Cáceres;Extremadura;225;115;110
4727;Vianos;Albacete;Castilla-La Mancha;346;174;172
1146;Viator;Almería;Andalucía;5885;3004;2881
157;Vic;Barcelona;Cataluña;46214;23306;22908
301;Vícar;Almería;Andalucía;26028;14017;12011
2463;Vicedo, O;Lugo;Galicia;1675;821;854
6565;Vicién;Huesca;Aragón;113;66;47
811;Victoria de Acentejo, La;Santa Cruz de Tenerife;Canarias;9185;4604;4581
2097;Victoria, La;Córdoba;Andalucía;2271;1131;1140
7843;Vid de Bureba, La;Burgos;Castilla y León;33;19;14
6876;Vid de Ojeda, La;Palencia;Castilla y León;94;57;37
5219;Vid y Barrios, La;Burgos;Castilla y León;259;149;110
6931;Vidángoz/Bidankoze;Navarra;Navarra;90;51;39
7008;Vidayanes;Zamora;Castilla y León;85;45;40
6190;Videmala;Zamora;Castilla y León;147;76;71
6605;Vídola, La;Salamanca;Castilla y León;111;55;56
5945;Vidrà;Girona;Cataluña;167;83;84
925;Vidreres;Girona;Cataluña;7797;4048;3749
1191;Vielha e Mijaran;Lleida;Cataluña;5559;2837;2722
7128;Vierlas;Zaragoza;Aragón;77;40;37
14;Vigo;Pontevedra;Galicia;295364;139699;155665
4543;Viguera;Rioja, La;La Rioja;387;222;165
1252;Vila de Cruces;Pontevedra;Galicia;5246;2578;2668
144;Vila-real;Castellón/Castelló;Comunidad Valenciana;50893;25282;25611
2807;Vila-rodona;Tarragona;Cataluña;1255;660;595
3508;Vila-sacra;Girona;Cataluña;760;372;388
3547;Vila-sana;Lleida;Cataluña;742;376;366
360;Vila-seca;Tarragona;Cataluña;22187;11113;11074
3561;Vilabella;Tarragona;Cataluña;736;378;358
3160;Vilabertran;Girona;Cataluña;979;489;490
1818;Vilablareix;Girona;Cataluña;2897;1438;1459
1148;Vilaboa;Pontevedra;Galicia;5874;2859;3015
4432;Vilada;Barcelona;Cataluña;416;217;199
4243;Viladamat;Girona;Cataluña;468;241;227
5641;Viladasens;Girona;Cataluña;200;107;93
114;Viladecans;Barcelona;Cataluña;66611;32930;33681
950;Viladecavalls;Barcelona;Cataluña;7512;3724;3788
3414;Vilademuls;Girona;Cataluña;815;424;391
3073;Viladrau;Girona;Cataluña;1040;509;531
2336;Vilafamés;Castellón/Castelló;Comunidad Valenciana;1842;997;845
1225;Vilafant;Girona;Cataluña;5394;2636;2758
2466;Vilaflor de Chasna;Santa Cruz de Tenerife;Canarias;1667;857;810
1655;Vilafranca de Bonany;Balears, Illes;Islas Baleares;3380;1733;1647
177;Vilafranca del Penedès;Barcelona;Cataluña;39746;19341;20405
2137;Vilafranca/Villafranca del Cid;Castellón/Castelló;Comunidad Valenciana;2200;1087;1113
193;Vilagarcía de Arousa;Pontevedra;Galicia;37456;17930;19526
4011;Vilagrassa;Lleida;Cataluña;541;278;263
2994;Vilajuïga;Girona;Cataluña;1104;549;555
567;Vilalba;Lugo;Galicia;14072;6817;7255
3806;Vilalba dels Arcs;Tarragona;Cataluña;625;318;307
3599;Vilalba Sasserra;Barcelona;Cataluña;716;357;359
3971;Vilaller;Lleida;Cataluña;561;294;267
4505;Vilallonga de Ter;Girona;Cataluña;398;212;186
2035;Vilallonga del Camp;Tarragona;Cataluña;2389;1206;1183
1429;Vilallonga/Villalonga;Valencia/València;Comunidad Valenciana;4270;2076;2194
4714;Vilamacolum;Girona;Cataluña;348;193;155
2889;Vilamalla;Girona;Cataluña;1181;586;595
5642;Vilamaniscle;Girona;Cataluña;200;116;84
2325;Vilamarín;Ourense;Galicia;1854;952;902
2380;Vilamartín de Valdeorras;Ourense;Galicia;1790;914;876
774;Vilamarxant;Valencia/València;Comunidad Valenciana;9717;5024;4693
5744;Vilamòs;Lleida;Cataluña;187;100;87
4525;Vilanant;Girona;Cataluña;392;197;195
3916;Vilanova d'Alcolea;Castellón/Castelló;Comunidad Valenciana;584;300;284
4004;Vilanova d'Escornalbou;Tarragona;Cataluña;545;288;257
740;Vilanova de Arousa;Pontevedra;Galicia;10302;4998;5304
2890;Vilanova de Bellpuig;Lleida;Cataluña;1181;599;582
5666;Vilanova de l'Aguda;Lleida;Cataluña;197;97;100
3079;Vilanova de la Barca;Lleida;Cataluña;1036;535;501
4534;Vilanova de Meià;Lleida;Cataluña;389;223;166
6594;Vilanova de Prades;Tarragona;Cataluña;112;60;52
4973;Vilanova de Sau;Barcelona;Cataluña;299;142;157
3165;Vilanova de Segrià;Lleida;Cataluña;977;518;459
626;Vilanova del Camí;Barcelona;Cataluña;12458;6227;6231
1215;Vilanova del Vallès;Barcelona;Cataluña;5432;2760;2672
112;Vilanova i la Geltrú;Barcelona;Cataluña;67086;32456;34630
3941;Vilaplana;Tarragona;Cataluña;574;302;272
2754;Vilar de Barrio;Ourense;Galicia;1307;661;646
5922;Vilar de Canes;Castellón/Castelló;Comunidad Valenciana;169;88;81
3405;Vilar de Santos;Ourense;Galicia;820;401;419
2333;Vilardevós;Ourense;Galicia;1846;948;898
4086;Vilariño de Conso;Ourense;Galicia;519;303;216
2845;Vilarmaior;Coruña, A;Galicia;1226;627;599
2853;Vilasantar;Coruña, A;Galicia;1213;642;571
827;Vilassar de Dalt;Barcelona;Cataluña;9043;4462;4581
387;Vilassar de Mar;Barcelona;Cataluña;20837;10068;10769
6055;Vilaür;Girona;Cataluña;157;81;76
1718;Vilavella, la;Castellón/Castelló;Comunidad Valenciana;3157;1569;1588
4299;Vilaverd;Tarragona;Cataluña;452;240;212
1403;Vilches;Jaén;Andalucía;4436;2216;2220
6318;Vilella Alta, La;Tarragona;Cataluña;135;73;62
5625;Vilella Baixa, La;Tarragona;Cataluña;202;113;89
7934;Vileña;Burgos;Castilla y León;28;18;10
1576;Villa de Don Fadrique, La;Toledo;Castilla-La Mancha;3664;1810;1854
1328;Villa de Mazo;Santa Cruz de Tenerife;Canarias;4843;2453;2390
1017;Villa de Otura;Granada;Andalucía;6952;3507;3445
7455;Villa de Ves;Albacete;Castilla-La Mancha;56;32;24
4181;Villa del Campo;Cáceres;Extremadura;487;229;258
1065;Villa del Prado;Madrid;Comunidad de Madrid;6520;3309;3211
6377;Villa del Rey;Cáceres;Extremadura;128;64;64
1001;Villa del Río;Córdoba;Andalucía;7104;3527;3577
4171;Villabáñez;Valladolid;Castilla y León;490;269;221
7928;Villabaruz de Campos;Valladolid;Castilla y León;29;15;14
7870;Villabasta de Valdavia;Palencia;Castilla y León;32;18;14
1832;Villablanca;Huelva;Andalucía;2848;1389;1459
858;Villablino;León;Castilla y León;8620;4241;4379
1151;Villabona;Gipuzkoa;País Vasco;5867;2939;2928
3080;Villabrágima;Valladolid;Castilla y León;1036;547;489
6834;Villabraz;León;Castilla y León;97;56;41
5281;Villabrázaro;Zamora;Castilla y León;252;130;122
4991;Villabuena de Álava/Eskuernaga;Araba/Álava;País Vasco;296;149;147
3691;Villabuena del Puente;Zamora;Castilla y León;675;343;332
783;Villacañas;Toledo;Castilla-La Mancha;9548;4735;4813
7093;Villacarralón;Valladolid;Castilla y León;79;47;32
2502;Villacarriedo;Cantabria;Cantabria;1612;845;767
712;Villacarrillo;Jaén;Andalucía;10726;5391;5335
2604;Villacastín;Segovia;Castilla y León;1481;775;706
7232;Villacid de Campos;Valladolid;Castilla y León;70;45;25
7526;Villacidaler;Palencia;Castilla y León;53;30;23
6979;Villaciervos;Soria;Castilla y León;87;53;34
7142;Villaco;Valladolid;Castilla y León;76;51;25
7361;Villaconancio;Palencia;Castilla y León;61;35;26
1651;Villaconejos;Madrid;Comunidad de Madrid;3388;1745;1643
4735;Villaconejos de Trabaque;Cuenca;Castilla-La Mancha;344;172;172
3247;Villada;Palencia;Castilla y León;934;481;453
2957;Villadangos del Páramo;León;Castilla y León;1132;588;544
4821;Villademor de la Vega;León;Castilla y León;327;172;155
5660;Villadepera;Zamora;Castilla y León;198;107;91
2596;Villadiego;Burgos;Castilla y León;1492;824;668
6912;Villadoz;Zaragoza;Aragón;92;51;41
7603;Villaeles de Valdavia;Palencia;Castilla y León;49;29;20
1510;Villaescusa;Cantabria;Cantabria;3899;1921;1978
5304;Villaescusa;Zamora;Castilla y León;249;136;113
4236;Villaescusa de Haro;Cuenca;Castilla-La Mancha;470;239;231
6659;Villaescusa de Roa;Burgos;Castilla y León;107;60;47
7410;Villaescusa la Sombría;Burgos;Castilla y León;58;42;16
8000;Villaespasa;Burgos;Castilla y León;23;14;9
4218;Villafáfila;Zamora;Castilla y León;478;249;229
5958;Villafeliche;Zaragoza;Aragón;166;90;76
6631;Villaferrueña;Zamora;Castilla y León;110;56;54
6561;Villaflor;Ávila;Castilla y León;113;60;53
5106;Villaflores;Salamanca;Castilla y León;277;139;138
7290;Villafrades de Campos;Valladolid;Castilla y León;66;37;29
1833;Villafranca;Navarra;Navarra;2847;1438;1409
1319;Villafranca de Córdoba;Córdoba;Andalucía;4871;2486;2385
5228;Villafranca de Duero;Valladolid;Castilla y León;258;135;123
3384;Villafranca de Ebro;Zaragoza;Aragón;833;416;417
6321;Villafranca de la Sierra;Ávila;Castilla y León;134;77;57
610;Villafranca de los Barros;Badajoz;Extremadura;12835;6311;6524
1317;Villafranca de los Caballeros;Toledo;Castilla-La Mancha;4896;2421;2475
1817;Villafranca del Bierzo;León;Castilla y León;2899;1385;1514
4982;Villafranca del Campo;Teruel;Aragón;298;155;143
6441;Villafranca Montes de Oca;Burgos;Castilla y León;122;74;48
4172;Villafrechós;Valladolid;Castilla y León;490;266;224
5756;Villafruela;Burgos;Castilla y León;186;109;77
7078;Villafuerte;Valladolid;Castilla y León;80;45;35
3126;Villafufre;Cantabria;Cantabria;1003;527;476
7341;Villagalijo;Burgos;Castilla y León;62;37;25
4937;Villagarcía de Campos;Valladolid;Castilla y León;307;184;123
3284;Villagarcía de la Torre;Badajoz;Extremadura;907;468;439
3514;Villagarcía del Llano;Cuenca;Castilla-La Mancha;759;383;376
3839;Villagatón;León;Castilla y León;613;324;289
7481;Villageriz;Zamora;Castilla y León;56;34;22
7255;Villagómez la Nueva;Valladolid;Castilla y León;68;35;33
2833;Villagonzalo;Badajoz;Extremadura;1234;601;633
5527;Villagonzalo de Tormes;Salamanca;Castilla y León;216;128;88
2349;Villagonzalo Pedernales;Burgos;Castilla y León;1827;959;868
6684;Villahán;Palencia;Castilla y León;106;56;50
3822;Villaharta;Córdoba;Andalucía;619;301;318
2352;Villahermosa;Ciudad Real;Castilla-La Mancha;1826;891;935
6956;Villahermosa del Campo;Teruel;Aragón;89;57;32
4174;Villahermosa del Río;Castellón/Castelló;Comunidad Valenciana;489;268;221
5629;Villaherreros;Palencia;Castilla y León;201;104;97
5009;Villahoz;Burgos;Castilla y León;293;158;135
213;Villajoyosa/Vila Joiosa, la;Alicante/Alacant;Comunidad Valenciana;34673;17296;17377
7469;Villalaco;Palencia;Castilla y León;56;32;24
7860;Villalán de Campos;Valladolid;Castilla y León;33;21;12
4246;Villalar de los Comuneros;Valladolid;Castilla y León;468;225;243
5165;Villalazán;Zamora;Castilla y León;267;132;135
3635;Villalba de Duero;Burgos;Castilla y León;699;362;337
5746;Villalba de Guardo;Palencia;Castilla y León;187;101;86
5450;Villalba de la Lampreana;Zamora;Castilla y León;227;126;101
7499;Villalba de la Loma;Valladolid;Castilla y León;55;30;25
4280;Villalba de la Sierra;Cuenca;Castilla-La Mancha;456;225;231
4578;Villalba de los Alcores;Valladolid;Castilla y León;379;206;173
2608;Villalba de los Barros;Badajoz;Extremadura;1477;746;731
6404;Villalba de los Llanos;Salamanca;Castilla y León;126;71;55
6854;Villalba de Perejil;Zaragoza;Aragón;96;48;48
6024;Villalba de Rioja;Rioja, La;La Rioja;160;100;60
1665;Villalba del Alcor;Huelva;Andalucía;3338;1644;1694
4093;Villalba del Rey;Cuenca;Castilla-La Mancha;516;282;234
6464;Villalbarba;Valladolid;Castilla y León;121;60;61
573;Villalbilla;Madrid;Comunidad de Madrid;13878;7002;6876
2664;Villalbilla de Burgos;Burgos;Castilla y León;1407;767;640
7056;Villalbilla de Gumiel;Burgos;Castilla y León;81;50;31
4386;Villalcampo;Zamora;Castilla y León;432;212;220
5898;Villalcázar de Sirga;Palencia;Castilla y León;172;88;84
7362;Villalcón;Palencia;Castilla y León;61;36;25
6871;Villaldemiro;Burgos;Castilla y León;94;54;40
4909;Villalengua;Zaragoza;Aragón;313;172;141
3008;Villalgordo del Júcar;Albacete;Castilla-La Mancha;1094;576;518
7068;Villalgordo del Marquesado;Cuenca;Castilla-La Mancha;80;42;38
4403;Villalmanzo;Burgos;Castilla y León;427;233;194
7418;Villalobar de Rioja;Rioja, La;La Rioja;58;42;16
2445;Villalobón;Palencia;Castilla y León;1690;853;837
5365;Villalobos;Zamora;Castilla y León;239;117;122
2509;Villalón de Campos;Valladolid;Castilla y León;1602;791;811
7063;Villalonso;Zamora;Castilla y León;81;46;35
2615;Villalpando;Zamora;Castilla y León;1475;720;755
3105;Villalpardo;Cuenca;Castilla-La Mancha;1018;504;514
5929;Villalube;Zamora;Castilla y León;169;90;79
1534;Villaluenga de la Sagra;Toledo;Castilla-La Mancha;3815;1905;1910
3880;Villaluenga de la Vega;Palencia;Castilla y León;595;340;255
4284;Villaluenga del Rosario;Cádiz;Andalucía;455;243;212
1488;Villamalea;Albacete;Castilla-La Mancha;4027;2034;1993
7343;Villamalur;Castellón/Castelló;Comunidad Valenciana;62;37;25
5005;Villamandos;León;Castilla y León;294;159;135
3220;Villamanín;León;Castilla y León;949;483;466
2938;Villamanrique;Ciudad Real;Castilla-La Mancha;1148;560;588
1396;Villamanrique de la Condesa;Sevilla;Andalucía;4459;2201;2258
3629;Villamanrique de Tajo;Madrid;Comunidad de Madrid;703;352;351
1954;Villamanta;Madrid;Comunidad de Madrid;2555;1299;1256
2647;Villamantilla;Madrid;Comunidad de Madrid;1441;709;732
2964;Villamañán;León;Castilla y León;1126;568;558
638;Villamartín;Cádiz;Andalucía;12150;6109;6041
5862;Villamartín de Campos;Palencia;Castilla y León;176;100;76
5858;Villamartín de Don Sancho;León;Castilla y León;176;96;80
993;Villamayor;Salamanca;Castilla y León;7202;3622;3580
3784;Villamayor de Calatrava;Ciudad Real;Castilla-La Mancha;634;313;321
4795;Villamayor de Campos;Zamora;Castilla y León;333;167;166
1882;Villamayor de Gállego;Zaragoza;Aragón;2720;1361;1359
5911;Villamayor de los Montes;Burgos;Castilla y León;170;81;89
6481;Villamayor de Monjardín;Navarra;Navarra;119;61;58
1993;Villamayor de Santiago;Cuenca;Castilla-La Mancha;2481;1258;1223
7328;Villamayor de Treviño;Burgos;Castilla y León;63;32;31
7668;Villambistia;Burgos;Castilla y León;44;32;12
5876;Villamediana;Palencia;Castilla y León;175;97;78
897;Villamediana de Iregua;Rioja, La;La Rioja;8070;4078;3992
8107;Villamedianilla;Burgos;Castilla y León;12;7;5
3661;Villamejil;León;Castilla y León;687;368;319
3225;Villamena;Granada;Andalucía;948;479;469
6583;Villameriel;Palencia;Castilla y León;112;62;50
5204;Villamesías;Cáceres;Extremadura;261;136;125
4471;Villamiel;Cáceres;Extremadura;407;205;202
7655;Villamiel de la Sierra;Burgos;Castilla y León;45;27;18
3322;Villamiel de Toledo;Toledo;Castilla-La Mancha;873;447;426
4060;Villaminaya;Toledo;Castilla-La Mancha;527;264;263
5968;Villamol;León;Castilla y León;164;85;79
3606;Villamontán de la Valduerna;León;Castilla y León;715;378;337
4553;Villamor de los Escuderos;Zamora;Castilla y León;384;203;181
6228;Villamoratiel de las Matas;León;Castilla y León;143;81;62
5377;Villamoronta;Palencia;Castilla y León;237;139;98
3842;Villamuelas;Toledo;Castilla-La Mancha;612;322;290
7689;Villamuera de la Cueza;Palencia;Castilla y León;43;28;15
7549;Villamuriel de Campos;Valladolid;Castilla y León;52;27;25
1070;Villamuriel de Cerrato;Palencia;Castilla y León;6469;3345;3124
6391;Villán de Tordesillas;Valladolid;Castilla y León;127;75;52
5126;Villanázar;Zamora;Castilla y León;274;143;131
5543;Villangómez;Burgos;Castilla y León;214;132;82
5935;Villanova;Huesca;Aragón;168;81;87
4382;Villanúa;Huesca;Aragón;432;224;208
1883;Villanubla;Valladolid;Castilla y León;2713;1401;1312
1697;Villanueva de Alcardete;Toledo;Castilla-La Mancha;3250;1675;1575
6161;Villanueva de Alcorón;Guadalajara;Castilla-La Mancha;149;82;67
1452;Villanueva de Algaidas;Málaga;Andalucía;4176;2143;2033
6477;Villanueva de Argaño;Burgos;Castilla y León;119;65;54
7884;Villanueva de Argecilla;Guadalajara;Castilla-La Mancha;31;19;12
5453;Villanueva de Ávila;Ávila;Castilla y León;226;118;108
4707;Villanueva de Azoague;Zamora;Castilla y León;350;177;173
3613;Villanueva de Bogas;Toledo;Castilla-La Mancha;712;370;342
7177;Villanueva de Cameros;Rioja, La;La Rioja;74;41;33
6598;Villanueva de Campeán;Zamora;Castilla y León;112;63;49
7955;Villanueva de Carazo;Burgos;Castilla y León;27;16;11
1008;Villanueva de Castellón;Valencia/València;Comunidad Valenciana;7049;3474;3575
851;Villanueva de Córdoba;Córdoba;Andalucía;8729;4331;4398
2887;Villanueva de Duero;Valladolid;Castilla y León;1184;619;565
1345;Villanueva de Gállego;Zaragoza;Aragón;4720;2368;2352
6530;Villanueva de Gómez;Ávila;Castilla y León;115;65;50
8125;Villanueva de Gormaz;Soria;Castilla y León;8;6;2
7300;Villanueva de Guadamejud;Cuenca;Castilla-La Mancha;65;39;26
5094;Villanueva de Gumiel;Burgos;Castilla y León;279;146;133
4340;Villanueva de Huerva;Zaragoza;Aragón;443;229;214
7518;Villanueva de Jiloca;Zaragoza;Aragón;54;27;27
373;Villanueva de la Cañada;Madrid;Comunidad de Madrid;21445;10430;11015
1682;Villanueva de la Concepción;Málaga;Andalucía;3296;1612;1684
7372;Villanueva de la Condesa;Valladolid;Castilla y León;61;34;27
2195;Villanueva de la Fuente;Ciudad Real;Castilla-La Mancha;2078;1062;1016
2116;Villanueva de la Jara;Cuenca;Castilla-La Mancha;2249;1133;1116
1738;Villanueva de la Reina;Jaén;Andalucía;3081;1544;1537
306;Villanueva de la Serena;Badajoz;Extremadura;25667;12486;13181
4279;Villanueva de la Sierra;Cáceres;Extremadura;456;231;225
1055;Villanueva de la Torre;Guadalajara;Castilla-La Mancha;6573;3308;3265
2241;Villanueva de la Vera;Cáceres;Extremadura;2021;1013;1008
4604;Villanueva de las Cruces;Huelva;Andalucía;373;176;197
4179;Villanueva de las Manzanas;León;Castilla y León;488;258;230
7113;Villanueva de las Peras;Zamora;Castilla y León;78;38;40
3923;Villanueva de las Torres;Granada;Andalucía;582;311;271
5878;Villanueva de los Caballeros;Valladolid;Castilla y León;175;93;82
1849;Villanueva de los Castillejos;Huelva;Andalucía;2820;1411;1409
1313;Villanueva de los Infantes;Ciudad Real;Castilla-La Mancha;4935;2446;2489
6766;Villanueva de los Infantes;Valladolid;Castilla y León;102;62;40
5015;Villanueva de Oscos;Asturias;Principado de Asturias;292;146;146
2541;Villanueva de Perales;Madrid;Comunidad de Madrid;1563;801;762
5027;Villanueva de San Carlos;Ciudad Real;Castilla-La Mancha;290;155;135
2976;Villanueva de San Juan;Sevilla;Andalucía;1120;550;570
6980;Villanueva de San Mancio;Valladolid;Castilla y León;87;48;39
4530;Villanueva de Sigena;Huesca;Aragón;390;201;189
2611;Villanueva de Tapia;Málaga;Andalucía;1476;744;732
7683;Villanueva de Teba;Burgos;Castilla y León;43;28;15
7357;Villanueva de Viver;Castellón/Castelló;Comunidad Valenciana;61;34;27
6489;Villanueva del Aceral;Ávila;Castilla y León;118;59;59
1051;Villanueva del Ariscal;Sevilla;Andalucía;6610;3209;3401
889;Villanueva del Arzobispo;Jaén;Andalucía;8193;4214;3979
6768;Villanueva del Campillo;Ávila;Castilla y León;101;56;45
3409;Villanueva del Campo;Zamora;Castilla y León;818;403;415
5890;Villanueva del Conde;Salamanca;Castilla y León;173;85;88
2631;Villanueva del Duque;Córdoba;Andalucía;1461;743;718
1648;Villanueva del Fresno;Badajoz;Extremadura;3397;1697;1700
479;Villanueva del Pardillo;Madrid;Comunidad de Madrid;17180;8389;8791
7156;Villanueva del Rebollar;Palencia;Castilla y León;75;37;38
7759;Villanueva del Rebollar de la Sierra;Teruel;Aragón;39;24;15
3066;Villanueva del Rey;Córdoba;Andalucía;1046;513;533
1812;Villanueva del Río Segura;Murcia;Región de Murcia;2910;1445;1465
1324;Villanueva del Río y Minas;Sevilla;Andalucía;4858;2459;2399
1661;Villanueva del Rosario;Málaga;Andalucía;3356;1649;1707
1244;Villanueva del Trabuco;Málaga;Andalucía;5299;2659;2640
2242;Villanueva Mesía;Granada;Andalucía;2021;994;1027
6962;Villanuño de Valdavia;Palencia;Castilla y León;88;51;37
4010;Villaobispo de Otero;León;Castilla y León;541;296;245
4677;Villaornate y Castro;León;Castilla y León;356;183;173
3919;Villapalacios;Albacete;Castilla-La Mancha;583;304;279
7397;Villaprovedo;Palencia;Castilla y León;59;40;19
3328;Villaquejida;León;Castilla y León;870;446;424
443;Villaquilambre;León;Castilla y León;18638;9230;9408
7656;Villaquirán de la Puebla;Burgos;Castilla y León;45;28;17
6042;Villaquirán de los Infantes;Burgos;Castilla y León;158;82;76
6823;Villar de Argañán;Salamanca;Castilla y León;98;53;45
3886;Villar de Arnedo, El;Rioja, La;La Rioja;593;306;287
4599;Villar de Cañas;Cuenca;Castilla-La Mancha;374;204;170
5107;Villar de Ciervo;Salamanca;Castilla y León;277;146;131
7837;Villar de Corneja;Ávila;Castilla y León;33;19;14
5496;Villar de Domingo García;Cuenca;Castilla-La Mancha;220;109;111
7663;Villar de Fallaves;Zamora;Castilla y León;45;25;20
5702;Villar de Gallimazo;Salamanca;Castilla y León;192;118;74
6100;Villar de la Encina;Cuenca;Castilla-La Mancha;154;84;70
5883;Villar de la Yegua;Salamanca;Castilla y León;174;91;83
6697;Villar de los Navarros;Zaragoza;Aragón;106;60;46
2786;Villar de Olalla;Cuenca;Castilla-La Mancha;1270;682;588
5415;Villar de Peralonso;Salamanca;Castilla y León;231;119;112
5381;Villar de Plasencia;Cáceres;Extremadura;235;127;108
2680;Villar de Rena;Badajoz;Extremadura;1379;709;670
6965;Villar de Samaniego;Salamanca;Castilla y León;88;49;39
6048;Villar de Torre;Rioja, La;La Rioja;158;97;61
7571;Villar del Ala;Soria;Castilla y León;51;27;24
1600;Villar del Arzobispo;Valencia/València;Comunidad Valenciana;3554;1803;1751
3952;Villar del Buey;Zamora;Castilla y León;571;296;275
8027;Villar del Campo;Soria;Castilla y León;22;14;8
5973;Villar del Cobo;Teruel;Aragón;164;97;67
5780;Villar del Humo;Cuenca;Castilla-La Mancha;184;102;82
7684;Villar del Infantado;Cuenca;Castilla-La Mancha;43;23;20
2250;Villar del Olmo;Madrid;Comunidad de Madrid;2011;1003;1008
3874;Villar del Pedroso;Cáceres;Extremadura;599;310;289
7151;Villar del Pozo;Ciudad Real;Castilla-La Mancha;75;41;34
2177;Villar del Rey;Badajoz;Extremadura;2117;1125;992
6284;Villar del Río;Soria;Castilla y León;139;85;54
7498;Villar del Salz;Teruel;Aragón;55;34;21
7117;Villar y Velasco;Cuenca;Castilla-La Mancha;77;44;33
2357;Villaralbo;Zamora;Castilla y León;1821;919;902
2960;Villaralto;Córdoba;Andalucía;1131;569;562
1475;Villarcayo de Merindad de Castilla la Vieja;Burgos;Castilla y León;4097;2098;1999
4446;Villardeciervos;Zamora;Castilla y León;413;207;206
5917;Villardefrades;Valladolid;Castilla y León;170;96;74
6392;Villardiegua de la Ribera;Zamora;Castilla y León;127;68;59
7126;Villárdiga;Zamora;Castilla y León;77;44;33
3189;Villardompardo;Jaén;Andalucía;965;488;477
6671;Villardondiego;Zamora;Castilla y León;107;60;47
7960;Villarejo;Rioja, La;La Rioja;27;20;7
4395;Villarejo de Fuentes;Cuenca;Castilla-La Mancha;429;215;214
8046;Villarejo de la Peñuela;Cuenca;Castilla-La Mancha;20;9;11
7178;Villarejo de Montalbán;Toledo;Castilla-La Mancha;74;39;35
1787;Villarejo de Órbigo;León;Castilla y León;2974;1459;1515
979;Villarejo de Salvanés;Madrid;Comunidad de Madrid;7335;3692;3643
4719;Villarejo del Valle;Ávila;Castilla y León;347;183;164
4570;Villarejo-Periesteban;Cuenca;Castilla-La Mancha;380;190;190
7659;Villares de Jadraque;Guadalajara;Castilla-La Mancha;45;28;17
1083;Villares de la Reina;Salamanca;Castilla y León;6351;3147;3204
3846;Villares de Órbigo;León;Castilla y León;611;325;286
6970;Villares de Soria, Los;Soria;Castilla y León;88;49;39
6566;Villares de Yeltes;Salamanca;Castilla y León;113;52;61
4337;Villares del Saz;Cuenca;Castilla-La Mancha;443;226;217
1128;Villares, Los;Jaén;Andalucía;6014;3004;3010
3901;Villargordo del Cabriel;Valencia/València;Comunidad Valenciana;589;304;285
3757;Villariezo;Burgos;Castilla y León;644;357;287
3445;Villarino de los Aires;Salamanca;Castilla y León;796;416;380
5916;Villarluengo;Teruel;Aragón;170;99;71
5775;Villarmayor;Salamanca;Castilla y León;185;104;81
8077;Villarmentero de Campos;Palencia;Castilla y León;17;12;5
6611;Villarmentero de Esgueva;Valladolid;Castilla y León;111;61;50
7741;Villarmuerto;Salamanca;Castilla y León;40;27;13
3337;Villarquemado;Teruel;Aragón;863;447;416
5590;Villarrabé;Palencia;Castilla y León;208;107;101
3406;Villarramiel;Palencia;Castilla y León;820;446;374
2147;Villarrasa;Huelva;Andalucía;2176;1103;1073
5127;Villarreal de Huerva;Zaragoza;Aragón;274;152;122
4562;Villarrín de Campos;Zamora;Castilla y León;383;206;177
314;Villarrobledo;Albacete;Castilla-La Mancha;25184;12456;12728
4483;Villarrodrigo;Jaén;Andalucía;405;215;190
8130;Villarroya;Rioja, La;La Rioja;5;3;2
4329;Villarroya de la Sierra;Zaragoza;Aragón;446;234;212
5899;Villarroya de los Pinares;Teruel;Aragón;172;92;80
7180;Villarroya del Campo;Zaragoza;Aragón;74;40;34
766;Villarrubia de los Ojos;Ciudad Real;Castilla-La Mancha;9814;4878;4936
1963;Villarrubia de Santiago;Toledo;Castilla-La Mancha;2536;1264;1272
5685;Villarrubio;Cuenca;Castilla-La Mancha;194;109;85
3447;Villarta;Cuenca;Castilla-La Mancha;793;393;400
4361;Villarta de los Montes;Badajoz;Extremadura;437;221;216
1857;Villarta de San Juan;Ciudad Real;Castilla-La Mancha;2791;1410;1381
6269;Villarta-Quintana;Rioja, La;La Rioja;140;83;57
5568;Villas de la Ventosa;Cuenca;Castilla-La Mancha;211;123;88
2973;Villasabariego;León;Castilla y León;1121;588;533
5767;Villasandino;Burgos;Castilla y León;185;108;77
6256;Villasarracino;Palencia;Castilla y León;141;86;55
7272;Villasayas;Soria;Castilla y León;67;44;23
5722;Villasbuenas;Salamanca;Castilla y León;190;104;86
4684;Villasbuenas de Gata;Cáceres;Extremadura;354;173;181
8038;Villasdardo;Salamanca;Castilla y León;21;6;15
7947;Villaseca de Arciel;Soria;Castilla y León;28;16;12
7957;Villaseca de Henares;Guadalajara;Castilla-La Mancha;27;13;14
2358;Villaseca de la Sagra;Toledo;Castilla-La Mancha;1820;904;916
7750;Villaseca de Uceda;Guadalajara;Castilla-La Mancha;39;21;18
6316;Villaseco de los Gamitos;Salamanca;Castilla y León;135;77;58
4801;Villaseco de los Reyes;Salamanca;Castilla y León;331;189;142
5417;Villaseco del Pan;Zamora;Castilla y León;231;108;123
5651;Villaselán;León;Castilla y León;199;116;83
1996;Villasequilla;Toledo;Castilla-La Mancha;2478;1277;1201
7165;Villasexmir;Valladolid;Castilla y León;75;42;33
7203;Villasila de Valdavia;Palencia;Castilla y León;72;49;23
5142;Villasrubias;Salamanca;Castilla y León;271;149;122
4128;Villastar;Teruel;Aragón;505;252;253
5155;Villasur de Herreros;Burgos;Castilla y León;268;164;104
2029;Villatobas;Toledo;Castilla-La Mancha;2403;1228;1175
5989;Villatoro;Ávila;Castilla y León;162;94;68
1417;Villatorres;Jaén;Andalucía;4316;2184;2132
6634;Villatoya;Albacete;Castilla-La Mancha;109;65;44
7715;Villatuelda;Burgos;Castilla y León;41;21;20
2875;Villatuerta;Navarra;Navarra;1191;597;594
6034;Villaturde;Palencia;Castilla y León;159;85;74
2328;Villaturiel;León;Castilla y León;1852;975;877
3747;Villaumbrales;Palencia;Castilla y León;648;322;326
743;Villava/Atarrabia;Navarra;Navarra;10204;4965;5239
5461;Villavaliente;Albacete;Castilla-La Mancha;224;136;88
6039;Villavaquerín;Valladolid;Castilla y León;159;91;68
7583;Villavelayo;Rioja, La;La Rioja;50;33;17
7453;Villavellid;Valladolid;Castilla y León;57;37;20
6006;Villavendimio;Zamora;Castilla y León;162;100;62
4763;Villaverde de Guadalimar;Albacete;Castilla-La Mancha;338;173;165
6257;Villaverde de Guareña;Salamanca;Castilla y León;141;80;61
3860;Villaverde de Íscar;Segovia;Castilla y León;604;315;289
4036;Villaverde de Medina;Valladolid;Castilla y León;533;289;244
7962;Villaverde de Montejo;Segovia;Castilla y León;27;17;10
7472;Villaverde de Rioja;Rioja, La;La Rioja;56;32;24
6533;Villaverde del Monte;Burgos;Castilla y León;115;66;49
923;Villaverde del Río;Sevilla;Andalucía;7818;3932;3886
4797;Villaverde y Pasaconsol;Cuenca;Castilla-La Mancha;332;176;156
7172;Villaverde-Mogina;Burgos;Castilla y León;74;50;24
7127;Villaveza de Valverde;Zamora;Castilla y León;77;39;38
5753;Villaveza del Agua;Zamora;Castilla y León;187;103;84
5330;Villavicencio de los Caballeros;Valladolid;Castilla y León;245;116;129
558;Villaviciosa;Asturias;Principado de Asturias;14439;7146;7293
1702;Villaviciosa de Córdoba;Córdoba;Andalucía;3229;1663;1566
277;Villaviciosa de Odón;Madrid;Comunidad de Madrid;27835;13493;14342
3500;Villavieja de Yeltes;Salamanca;Castilla y León;764;401;363
5265;Villavieja del Lozoya;Madrid;Comunidad de Madrid;253;136;117
4672;Villaviudas;Palencia;Castilla y León;357;174;183
5757;Villayerno Morquillas;Burgos;Castilla y León;186;95;91
2857;Villayón;Asturias;Principado de Asturias;1206;623;583
3709;Villazala;León;Castilla y León;665;353;312
4422;Villazanzo de Valderaduey;León;Castilla y León;419;244;175
7506;Villazopeque;Burgos;Castilla y León;54;33;21
6974;Villegas;Burgos;Castilla y León;87;49;38
6627;Villeguillo;Segovia;Castilla y León;110;61;49
4814;Villel;Teruel;Aragón;329;183;146
5810;Villel de Mesa;Guadalajara;Castilla-La Mancha;182;102;80
218;Villena;Alicante/Alacant;Comunidad Valenciana;33964;17056;16908
6934;Villerías de Campos;Palencia;Castilla y León;90;49;41
8068;Villodre;Palencia;Castilla y León;18;11;7
6549;Villodrigo;Palencia;Castilla y León;114;61;53
4658;Villoldo;Palencia;Castilla y León;362;190;172
6545;Víllora;Cuenca;Castilla-La Mancha;114;60;54
7749;Villores;Castellón/Castelló;Comunidad Valenciana;39;19;20
2715;Villoria;Salamanca;Castilla y León;1351;692;659
7199;Villoruebo;Burgos;Castilla y León;72;47;25
3511;Villoruela;Salamanca;Castilla y León;760;384;376
4840;Villoslada de Cameros;Rioja, La;La Rioja;324;200;124
4792;Villota del Páramo;Palencia;Castilla y León;333;186;147
7137;Villovieco;Palencia;Castilla y León;76;39;37
1684;Vilobí d'Onyar;Girona;Cataluña;3291;1711;1580
2991;Vilobí del Penedès;Barcelona;Cataluña;1107;569;538
5623;Vilopriu;Girona;Cataluña;202;107;95
4761;Viloria;Valladolid;Castilla y León;340;177;163
7716;Viloria de Rioja;Burgos;Castilla y León;41;24;17
5923;Vilosell, El;Lleida;Cataluña;169;88;81
7208;Vilueña, La;Zaragoza;Aragón;72;35;37
4398;Vilvestre;Salamanca;Castilla y León;429;210;219
4082;Vilviestre del Pinar;Burgos;Castilla y León;520;287;233
3295;Vimbodí i Poblet;Tarragona;Cataluña;892;488;404
1006;Vimianzo;Coruña, A;Galicia;7057;3380;3677
5287;Vinaceite;Teruel;Aragón;251;136;115
4237;Vinaixa;Lleida;Cataluña;470;249;221
1640;Vinalesa;Valencia/València;Comunidad Valenciana;3420;1657;1763
269;Vinaròs;Castellón/Castelló;Comunidad Valenciana;28682;14169;14513
8108;Vindel;Cuenca;Castilla-La Mancha;11;7;4
4401;Vinebre;Tarragona;Cataluña;428;221;207
7120;Viniegra de Abajo;Rioja, La;La Rioja;77;48;29
7709;Viniegra de Arriba;Rioja, La;La Rioja;42;28;14
3349;Vinuesa;Soria;Castilla y León;855;459;396
2211;Vinyols i els Arcs;Tarragona;Cataluña;2056;1070;986
5834;Viñas;Zamora;Castilla y León;180;95;85
7430;Viñegra de Moraña;Ávila;Castilla y León;57;32;25
2226;Viñuela;Málaga;Andalucía;2034;1061;973
6172;Viñuelas;Guadalajara;Castilla-La Mancha;148;75;73
6485;Visiedo;Teruel;Aragón;119;53;66
1406;Viso de San Juan, El;Toledo;Castilla-La Mancha;4416;2364;2052
427;Viso del Alcor, El;Sevilla;Andalucía;19266;9628;9638
2079;Viso del Marqués;Ciudad Real;Castilla-La Mancha;2298;1109;1189
1962;Viso, El;Córdoba;Andalucía;2536;1265;1271
7608;Vistabella;Zaragoza;Aragón;49;28;21
4762;Vistabella del Maestrat;Castellón/Castelló;Comunidad Valenciana;339;186;153
7014;Vita;Ávila;Castilla y León;84;49;35
1983;Vitigudino;Salamanca;Castilla y León;2499;1210;1289
17;Vitoria-Gasteiz;Araba/Álava;País Vasco;251774;122711;129063
526;Viveiro;Lugo;Galicia;15466;7559;7907
7196;Vivel del Río Martín;Teruel;Aragón;73;37;36
2555;Viver;Castellón/Castelló;Comunidad Valenciana;1536;800;736
5932;Viver i Serrateix;Barcelona;Cataluña;168;87;81
4770;Viveros;Albacete;Castilla-La Mancha;337;176;161
7640;Vizcaínos;Burgos;Castilla y León;46;32;14
7986;Vizmanos;Soria;Castilla y León;25;17;8
3167;Víznar;Granada;Andalucía;976;508;468
1879;Voto;Cantabria;Cantabria;2724;1456;1268
7775;Vozmediano;Soria;Castilla y León;38;24;14
4847;Wamba;Valladolid;Castilla y León;323;172;151
1877;Xaló;Alicante/Alacant;Comunidad Valenciana;2739;1378;1361
263;Xàtiva;Valencia/València;Comunidad Valenciana;29231;14288;14943
1179;Xeraco;Valencia/València;Comunidad Valenciana;5655;2853;2802
2149;Xeresa;Valencia/València;Comunidad Valenciana;2168;1109;1059
2369;Xermade;Lugo;Galicia;1806;882;924
3632;Xert;Castellón/Castelló;Comunidad Valenciana;701;338;363
2906;Xerta;Tarragona;Cataluña;1170;571;599
775;Xinzo de Limia;Ourense;Galicia;9715;4744;4971
258;Xirivella;Valencia/València;Comunidad Valenciana;29623;14658;14965
1690;Xove;Lugo;Galicia;3273;1625;1648
2686;Xunqueira de Ambía;Ourense;Galicia;1375;689;686
3537;Xunqueira de Espadanedo;Ourense;Galicia;745;370;375
496;Yaiza;Palmas, Las;Canarias;16571;8607;7964
6568;Yanguas;Soria;Castilla y León;113;75;38
6383;Yanguas de Eresma;Segovia;Castilla y León;128;66;62
2204;Yátova;Valencia/València;Comunidad Valenciana;2067;1068;999
1138;Yébenes, Los;Toledo;Castilla-La Mancha;5901;3016;2885
1539;Yebes;Guadalajara;Castilla-La Mancha;3791;1957;1834
4333;Yebra;Guadalajara;Castilla-La Mancha;444;240;204
6227;Yebra de Basa;Huesca;Aragón;143;86;57
214;Yecla;Murcia;Región de Murcia;34432;17267;17165
5385;Yecla de Yeltes;Salamanca;Castilla y León;235;124;111
5154;Yécora/Iekora;Araba/Álava;País Vasco;268;140;128
7215;Yélamos de Abajo;Guadalajara;Castilla-La Mancha;71;39;32
7103;Yélamos de Arriba;Guadalajara;Castilla-La Mancha;78;47;31
1237;Yeles;Toledo;Castilla-La Mancha;5329;2804;2525
7744;Yelo;Soria;Castilla y León;40;24;16
8034;Yémeda;Cuenca;Castilla-La Mancha;21;13;8
1261;Yepes;Toledo;Castilla-La Mancha;5198;2684;2514
6339;Yernes y Tameza;Asturias;Principado de Asturias;132;73;59
5019;Yesa;Navarra;Navarra;292;172;120
5432;Yesa, La;Valencia/València;Comunidad Valenciana;229;122;107
7440;Yésero;Huesca;Aragón;57;34;23
1908;Yeste;Albacete;Castilla-La Mancha;2657;1375;1282
1503;Yuncler;Toledo;Castilla-La Mancha;3940;2026;1914
3429;Yunclillos;Toledo;Castilla-La Mancha;809;421;388
683;Yuncos;Toledo;Castilla-La Mancha;11222;5736;5486
1827;Yunquera;Málaga;Andalucía;2864;1460;1404
1485;Yunquera de Henares;Guadalajara;Castilla-La Mancha;4044;2052;1992
6948;Yunta, La;Guadalajara;Castilla-La Mancha;89;53;36
4987;Zabalza/Zabaltza;Navarra;Navarra;297;160;137
6579;Zael;Burgos;Castilla y León;112;59;53
2169;Zafarraya;Granada;Andalucía;2137;1129;1008
489;Zafra;Badajoz;Extremadura;16797;8094;8703
6442;Zafra de Záncara;Cuenca;Castilla-La Mancha;122;68;54
7411;Zafrilla;Cuenca;Castilla-La Mancha;58;29;29
3380;Zagra;Granada;Andalucía;834;420;414
2675;Zahara;Cádiz;Andalucía;1387;709;678
1852;Zahínos;Badajoz;Extremadura;2803;1391;1412
4372;Zaida, La;Zaragoza;Aragón;435;219;216
2395;Zaidín;Huesca;Aragón;1763;929;834
1599;Zalamea de la Serena;Badajoz;Extremadura;3555;1788;1767
1745;Zalamea la Real;Huelva;Andalucía;3068;1545;1523
1757;Zaldibar;Bizkaia;País Vasco;3043;1526;1517
2501;Zaldibia;Gipuzkoa;País Vasco;1613;824;789
5787;Zalduondo;Araba/Álava;País Vasco;183;103;80
871;Zalla;Bizkaia;País Vasco;8447;4189;4258
6879;Zamarra;Salamanca;Castilla y León;94;58;36
5646;Zamayón;Salamanca;Castilla y León;200;121;79
4451;Zambrana;Araba/Álava;País Vasco;410;223;187
123;Zamora;Zamora;Castilla y León;61406;28524;32882
1693;Zamudio;Bizkaia;País Vasco;3260;1608;1652
6521;Zaorejas;Guadalajara;Castilla-La Mancha;116;77;39
6868;Zapardiel de la Cañada;Ávila;Castilla y León;94;50;44
6520;Zapardiel de la Ribera;Ávila;Castilla y León;116;60;56
5;Zaragoza;Zaragoza;Aragón;674997;322626;352371
7420;Zarapicos;Salamanca;Castilla y León;58;34;24
2499;Zaratamo;Bizkaia;País Vasco;1614;805;809
1101;Zaratán;Valladolid;Castilla y León;6233;3184;3049
343;Zarautz;Gipuzkoa;País Vasco;23323;11357;11966
4669;Zarra;Valencia/València;Comunidad Valenciana;359;200;159
5182;Zarratón;Rioja, La;La Rioja;264;139;125
2370;Zarza de Granadilla;Cáceres;Extremadura;1805;915;890
3950;Zarza de Montánchez;Cáceres;Extremadura;571;287;284
6217;Zarza de Pumareda, La;Salamanca;Castilla y León;144;82;62
5356;Zarza de Tajo;Cuenca;Castilla-La Mancha;239;138;101
2841;Zarza la Mayor;Cáceres;Extremadura;1228;610;618
4918;Zarza-Capilla;Badajoz;Extremadura;311;155;156
2791;Zarza-Perrunal, La;Huelva;Andalucía;1267;640;627
1629;Zarza, La;Badajoz;Extremadura;3472;1749;1723
6612;Zarza, La;Valladolid;Castilla y León;111;60;51
2474;Zarzalejo;Madrid;Comunidad de Madrid;1658;853;805
8101;Zarzosa;Rioja, La;La Rioja;14;10;4
7813;Zarzosa de Río Pisuerga;Burgos;Castilla y León;35;21;14
5913;Zarzuela;Cuenca;Castilla-La Mancha;170;91;79
7672;Zarzuela de Jadraque;Guadalajara;Castilla-La Mancha;44;27;17
4213;Zarzuela del Monte;Segovia;Castilla y León;479;252;227
4399;Zarzuela del Pinar;Segovia;Castilla y León;429;220;209
1392;Zas;Coruña, A;Galicia;4472;2154;2318
5578;Zazuar;Burgos;Castilla y León;210;110;100
2815;Zeanuri;Bizkaia;País Vasco;1250;639;611
3032;Zeberio;Bizkaia;País Vasco;1073;557;516
2563;Zegama;Gipuzkoa;País Vasco;1528;773;755
5221;Zerain;Gipuzkoa;País Vasco;259;124;135
1566;Zestoa;Gipuzkoa;País Vasco;3711;1939;1772
2597;Zierbena;Bizkaia;País Vasco;1490;785;705
2414;Zigoitia;Araba/Álava;País Vasco;1747;944;803
4716;Ziordia;Navarra;Navarra;348;182;166
4443;Ziortza-Bolibar;Bizkaia;País Vasco;413;219;194
545;Zizur Mayor/Zizur Nagusia;Navarra;Navarra;14894;7256;7638
1774;Zizurkil;Gipuzkoa;País Vasco;3002;1512;1490
7856;Zoma, La;Teruel;Aragón;33;18;15
2697;Zorita;Cáceres;Extremadura;1367;699;668
5972;Zorita de la Frontera;Salamanca;Castilla y León;164;83;81
7104;Zorita de los Canes;Guadalajara;Castilla-La Mancha;78;43;35
6543;Zorita del Maestrazgo;Castellón/Castelló;Comunidad Valenciana;114;59;55
6891;Zorraquín;Rioja, La;La Rioja;93;43;50
4404;Zotes del Páramo;León;Castilla y León;427;240;187
429;Zubia, La;Granada;Andalucía;19155;9460;9695
4958;Zubieta;Navarra;Navarra;303;157;146
5904;Zucaina;Castellón/Castelló;Comunidad Valenciana;171;97;74
861;Zuera;Zaragoza;Aragón;8565;4442;4123
3431;Zufre;Huelva;Andalucía;808;422;386
5503;Zugarramurdi;Navarra;Navarra;219;108;111
3766;Zuheros;Córdoba;Andalucía;641;328;313
2076;Zuia;Araba/Álava;País Vasco;2302;1190;1112
1955;Zújar;Granada;Andalucía;2548;1287;1261
750;Zumaia;Gipuzkoa;País Vasco;10098;5019;5079
772;Zumarraga;Gipuzkoa;País Vasco;9728;4791;4937
7461;Zuñeda;Burgos;Castilla y León;56;33;23
6640;Zúñiga;Navarra;Navarra;109;69;40
1772;Zurgena;Almería;Andalucía;3005;1490;1515